년,월,일,설비용량(MW),공급능력(MW),최대전력(MW),공급예비력(MW),공급예비율(%),최대전력기준일시
2025,08,14,155381,102903,84685,18218,21.5,2025/08/14(19:00)
2025,08,13,155381,102301,85279,17022,20,2025/08/13(19:00)
2025,08,12,155367,103327,85223,18104,21.2,2025/08/12(17:00)
2025,08,11,155367,103116,85071,18045,21.2,2025/08/11(15:00)
2025,08,10,155367,101346,73104,28242,38.6,2025/08/10(20:00)
2025,08,09,155367,99757,72350,27407,37.9,2025/08/09(12:00)
2025,08,08,155367,104122,84820,19302,22.8,2025/08/08(17:00)
2025,08,07,155367,103624,87053,16571,19,2025/08/07(19:00)
2025,08,06,155367,105126,87801,17325,19.7,2025/08/06(15:00)
2025,08,05,155308,104583,87891,16692,19,2025/08/05(19:00)
2025,08,04,155308,104736,86074,18662,21.7,2025/08/04(19:00)
2025,08,03,155308,102189,76329,25860,33.9,2025/08/03(19:00)
2025,08,02,155308,102020,80532,21488,26.7,2025/08/02(20:00)
2025,08,01,155308,104651,85678,18973,22.1,2025/08/01(20:00)
2025,07,31,155308,103514,86203,17311,20.1,2025/07/31(20:00)
2025,07,30,155308,104699,87806,16893,19.2,2025/07/30(18:00)
2025,07,29,155279,104001,90991,13010,14.3,2025/07/29(19:00)
2025,07,28,155279,103747,90985,12762,14,2025/07/28(19:00)
2025,07,27,155279,100874,82696,18178,22,2025/07/27(20:00)
2025,07,26,155279,100562,82821,17741,21.4,2025/07/26(20:00)
2025,07,25,155279,105584,90528,15056,16.6,2025/07/25(19:00)
2025,07,24,155279,106120,91379,14741,16.1,2025/07/24(19:00)
2025,07,23,155279,106061,89515,16546,18.5,2025/07/23(19:00)
2025,07,22,155242,105541,88890,16651,18.7,2025/07/22(19:00)
2025,07,21,155242,105513,86584,18929,21.9,2025/07/21(19:00)
2025,07,20,155242,101687,73579,28108,38.2,2025/07/20(20:00)
2025,07,19,155242,102900,70401,32499,46.2,2025/07/19(20:00)
2025,07,18,155242,105301,81588,23713,29.1,2025/07/18(17:00)
2025,07,17,155242,104436,82505,21931,26.6,2025/07/17(15:00)
2025,07,16,155242,104496,82918,21578,26,2025/07/16(11:00)
2025,07,15,155040,105859,78825,27034,34.3,2025/07/15(17:00)
2025,07,14,155040,106990,80116,26874,33.5,2025/07/14(17:00)
2025,07,13,155040,101057,71975,29082,40.4,2025/07/13(20:00)
2025,07,12,155040,100380,77144,23236,30.1,2025/07/12(20:00)
2025,07,11,155040,104489,87206,17283,19.8,2025/07/11(19:00)
2025,07,10,155040,105730,90717,15013,16.5,2025/07/10(19:00)
2025,07,09,155040,105326,92685,12641,13.6,2025/07/09(19:00)
2025,07,08,154955,105151,95675,9476,9.9,2025/07/08(18:00)
2025,07,07,154955,103441,93374,10067,10.8,2025/07/07(19:00)
2025,07,06,154955,96613,78705,17908,22.8,2025/07/06(20:00)
2025,07,05,154955,98867,77901,20966,26.9,2025/07/05(20:00)
2025,07,04,154955,100104,84920,15184,17.9,2025/07/04(17:00)
2025,07,03,154955,101520,89103,12417,13.9,2025/07/03(19:00)
2025,07,02,154955,101929,89069,12860,14.4,2025/07/02(19:00)
2025,07,01,154917,100114,89209,10905,12.2,2025/07/01(19:00)
2025,06,30,154917,99615,85599,13216,15.4,2025/06/30(19:00)
2025,06,29,154917,95631,72284,23347,32.3,2025/06/29(20:00)
2025,06,28,154917,96183,71638,24545,34.3,2025/06/28(20:00)
2025,06,27,154917,99306,76223,23083,30.3,2025/06/27(20:00)
2025,06,26,154917,98690,74223,24467,33,2025/06/26(19:00)
2025,06,25,154917,94869,73192,21677,29.6,2025/06/25(11:00)
2025,06,24,154727,94694,77050,17644,22.9,2025/06/24(15:00)
2025,06,23,154727,94389,77000,17389,22.6,2025/06/23(19:00)
2025,06,22,154727,91369,63748,27621,43.3,2025/06/22(21:00)
2025,06,21,154727,92592,67111,25481,38,2025/06/21(12:00)
2025,06,20,154727,94682,81637,13045,16,2025/06/20(11:00)
2025,06,19,154727,92859,80132,12727,15.9,2025/06/19(20:00)
2025,06,18,154727,92879,76769,15961,20.8,2025/06/18(19:00)
2025,06,17,154689,90185,76928,13257,17.2,2025/06/17(20:00)
2025,06,16,154689,92257,79094,13163,16.6,2025/06/16(11:00)
2025,06,15,154689,89942,68191,21751,31.9,2025/06/15(20:00)
2025,06,14,154689,89859,66062,23797,36,2025/06/14(20:00)
2025,06,13,154689,91996,73842,18154,24.6,2025/06/13(17:00)
2025,06,12,154689,91174,73440,17734,24.1,2025/06/12(18:00)
2025,06,11,154689,89768,70733,19035,26.9,2025/06/11(20:00)
2025,06,10,154673,90138,73235,16903,23.1,2025/06/10(19:00)
2025,06,09,154673,91281,74569,16712,22.4,2025/06/09(19:00)
2025,06,08,154673,87751,63953,23798,37.2,2025/06/08(21:00)
2025,06,07,154673,88659,61690,26969,43.7,2025/06/07(20:00)
2025,06,06,154673,88122,63003,25119,39.9,2025/06/06(20:00)
2025,06,05,154673,89246,68191,21055,30.9,2025/06/05(20:00)
2025,06,04,154673,87517,68127,19390,28.5,2025/06/04(20:00)
2025,06,03,154673,85310,62134,23176,37.3,2025/06/03(21:00)
2025,06,02,154673,85360,69209,16151,23.3,2025/06/02(17:00)
2025,06,01,154673,83305,60283,23022,38.2,2025/06/01(21:00)
2025,05,31,154673,83594,59788,23806,39.8,2025/05/31(21:00)
2025,05,30,154673,84669,67178,17491,26,2025/05/30(20:00)
2025,05,29,154673,85496,69244,16252,23.5,2025/05/29(20:00)
2025,05,28,154673,83734,68575,15159,22.1,2025/05/28(20:00)
2025,05,27,154557,83523,69448,14075,20.3,2025/05/27(20:00)
2025,05,26,154557,82182,68026,14156,20.8,2025/05/26(20:00)
2025,05,25,154557,81611,58337,23274,39.9,2025/05/25(21:00)
2025,05,24,154557,79061,58828,20233,34.4,2025/05/24(20:00)
2025,05,23,154557,83800,67177,16623,24.7,2025/05/23(17:00)
2025,05,22,154557,83491,71622,11869,16.6,2025/05/22(19:00)
2025,05,21,154557,82818,74239,8579,11.6,2025/05/21(17:00)
2025,05,20,154331,83045,72893,10152,13.9,2025/05/20(20:00)
2025,05,19,154331,82563,68353,14210,20.8,2025/05/19(20:00)
2025,05,18,154331,82893,58594,24299,41.5,2025/05/18(21:00)
2025,05,17,154331,82554,61203,21351,34.9,2025/05/17(20:00)
2025,05,16,154331,83521,72857,10664,14.6,2025/05/16(16:00)
2025,05,15,154331,83121,69998,13123,18.7,2025/05/15(10:00)
2025,05,14,154331,84774,68653,16121,23.5,2025/05/14(20:00)
2025,05,13,154303,84832,68714,16118,23.5,2025/05/13(20:00)
2025,05,12,154303,85150,67736,17414,25.7,2025/05/12(20:00)
2025,05,11,154303,84111,58905,25206,42.8,2025/05/11(21:00)
2025,05,10,154303,86600,59775,26825,44.9,2025/05/10(20:00)
2025,05,09,154303,88190,69578,18612,26.7,2025/05/09(11:00)
2025,05,08,154303,89412,66515,22897,34.4,2025/05/08(20:00)
2025,05,07,154303,89291,65492,23799,36.3,2025/05/07(20:00)
2025,05,06,154303,85307,59717,25590,42.9,2025/05/06(21:00)
2025,05,05,154303,84839,57374,27465,47.9,2025/05/05(20:00)
2025,05,04,154303,86483,55754,30729,55.1,2025/05/04(21:00)
2025,05,03,154303,87386,57168,30218,52.9,2025/05/03(21:00)
2025,05,02,154303,87454,61909,25545,41.3,2025/05/02(20:00)
2025,05,01,154303,86138,61111,25027,41,2025/05/01(20:00)
2025,04,30,154303,89492,65333,24159,37,2025/04/30(20:00)
2025,04,29,154297,89337,66232,23105,34.9,2025/04/29(20:00)
2025,04,28,154297,88876,66068,22808,34.5,2025/04/28(20:00)
2025,04,27,154297,86151,57477,28674,49.9,2025/04/27(20:00)
2025,04,26,154297,86674,57963,28711,49.5,2025/04/26(20:00)
2025,04,25,154297,89542,64865,24677,38,2025/04/25(20:00)
2025,04,24,154297,86588,66740,19848,29.7,2025/04/24(20:00)
2025,04,23,154297,85465,67083,18382,27.4,2025/04/23(20:00)
2025,04,22,153995,84839,69713,15126,21.7,2025/04/22(11:00)
2025,04,21,153995,84523,67710,16813,24.8,2025/04/21(20:00)
2025,04,20,153995,80884,58683,22201,37.8,2025/04/20(20:00)
2025,04,19,153995,82393,60286,22107,36.7,2025/04/19(20:00)
2025,04,18,153995,85881,66383,19498,29.4,2025/04/18(20:00)
2025,04,17,153995,84307,67939,16368,24.1,2025/04/17(20:00)
2025,04,16,153995,86187,67535,18652,27.6,2025/04/16(20:00)
2025,04,15,153931,87268,68752,18516,26.9,2025/04/15(20:00)
2025,04,14,153931,86002,71667,14335,20,2025/04/14(17:00)
2025,04,13,153931,86436,59804,26632,44.5,2025/04/13(20:00)
2025,04,12,153931,85568,58924,26644,45.2,2025/04/12(20:00)
2025,04,11,153931,86777,64924,21853,33.7,2025/04/11(20:00)
2025,04,10,153931,89284,67051,22233,33.2,2025/04/10(20:00)
2025,04,09,153931,89312,67503,21809,32.3,2025/04/09(20:00)
2025,04,08,153917,88327,67166,21161,31.5,2025/04/08(20:00)
2025,04,07,153917,89982,67482,22500,33.3,2025/04/07(20:00)
2025,04,06,153917,87708,58920,28788,48.9,2025/04/06(20:00)
2025,04,05,153917,88486,60778,27708,45.6,2025/04/05(20:00)
2025,04,04,153917,91237,66311,24926,37.6,2025/04/04(20:00)
2025,04,03,153917,89503,68704,20799,30.3,2025/04/03(20:00)
2025,04,02,153917,92237,69045,23192,33.6,2025/04/02(20:00)
2025,04,01,153905,90369,69182,21187,30.6,2025/04/01(20:00)
2025,03,31,153905,92271,69168,23103,33.4,2025/03/31(20:00)
2025,03,30,153905,88492,61624,26868,43.6,2025/03/30(20:00)
2025,03,29,153905,89041,62150,26891,43.3,2025/03/29(20:00)
2025,03,28,153905,91977,67840,24137,35.6,2025/03/28(20:00)
2025,03,27,153905,89034,69183,19851,28.7,2025/03/27(10:00)
2025,03,26,153905,89489,67221,22268,33.1,2025/03/26(20:00)
2025,03,25,153876,87894,68612,19282,28.1,2025/03/25(20:00)
2025,03,24,153876,89926,68066,21860,32.1,2025/03/24(20:00)
2025,03,23,153876,83744,59671,24073,40.3,2025/03/23(20:00)
2025,03,22,153876,85142,60131,25011,41.6,2025/03/22(20:00)
2025,03,21,153876,94596,68159,26437,38.8,2025/03/21(20:00)
2025,03,20,153876,96338,71832,24506,34.1,2025/03/20(20:00)
2025,03,19,153876,95753,74254,21499,29,2025/03/19(20:00)
2025,03,18,153738,95156,79892,15264,19.1,2025/03/18(10:00)
2025,03,17,153738,96562,74273,22289,30,2025/03/17(19:00)
2025,03,16,153738,89790,64455,25335,39.3,2025/03/16(20:00)
2025,03,15,153738,89309,61990,27319,44.1,2025/03/15(20:00)
2025,03,14,153738,100418,68297,32121,47,2025/03/14(20:00)
2025,03,13,153738,99378,71956,27422,38.1,2025/03/13(09:00)
2025,03,12,153738,96209,71900,24309,33.8,2025/03/12(10:00)
2025,03,11,153492,97773,71531,26242,36.7,2025/03/11(09:00)
2025,03,10,153492,99765,72266,27499,38.1,2025/03/10(19:00)
2025,03,09,153492,93255,62382,30873,49.5,2025/03/09(20:00)
2025,03,08,153492,93030,63786,29244,45.8,2025/03/08(20:00)
2025,03,07,153492,101100,74255,26845,36.2,2025/03/07(09:00)
2025,03,06,153492,101280,75167,26113,34.7,2025/03/06(09:00)
2025,03,05,153492,100976,80532,20444,25.4,2025/03/05(10:00)
2025,03,04,153477,99269,85127,14142,16.6,2025/03/04(11:00)
2025,03,03,153477,100423,67656,32767,48.4,2025/03/03(19:00)
2025,03,02,153477,99109,61922,37187,60.1,2025/03/02(20:00)
2025,03,01,153477,98746,63248,35498,56.1,2025/03/01(20:00)
2025,02,28,153477,103901,73438,30463,41.5,2025/02/28(10:00)
2025,02,27,153477,104748,75932,28816,37.9,2025/02/27(09:00)
2025,02,26,153477,104884,75917,28967,38.2,2025/02/26(09:00)
2025,02,25,153457,105816,77625,28191,36.3,2025/02/25(09:00)
2025,02,24,153457,105968,78296,27672,35.3,2025/02/24(19:00)
2025,02,23,153457,107540,68283,39257,57.5,2025/02/23(20:00)
2025,02,22,153457,107338,67988,39350,57.9,2025/02/22(20:00)
2025,02,21,153457,108665,80061,28604,35.7,2025/02/21(09:00)
2025,02,20,153457,108414,79895,28519,35.7,2025/02/20(09:00)
2025,02,19,153457,106630,79643,26987,33.9,2025/02/19(09:00)
2025,02,18,153445,107417,79075,28342,35.8,2025/02/18(19:00)
2025,02,17,153445,106688,78114,28574,36.6,2025/02/17(19:00)
2025,02,16,153445,104733,64423,40310,62.6,2025/02/16(20:00)
2025,02,15,153445,102780,66243,36537,55.2,2025/02/15(19:00)
2025,02,14,153445,107488,78786,28702,36.4,2025/02/14(09:00)
2025,02,13,153445,107833,81305,26528,32.6,2025/02/13(09:00)
2025,02,12,153445,104556,89324,15232,17.1,2025/02/12(11:00)
2025,02,11,153417,105441,83362,22079,26.5,2025/02/11(09:00)
2025,02,10,153417,105916,84699,21217,25,2025/02/10(10:00)
2025,02,09,153417,104152,70270,33882,48.2,2025/02/09(20:00)
2025,02,08,153417,103707,73299,30408,41.5,2025/02/08(19:00)
2025,02,07,153417,108809,90638,18171,20,2025/02/07(11:00)
2025,02,06,153417,108500,86315,22185,25.7,2025/02/06(09:00)
2025,02,05,153417,107989,86996,20993,24.1,2025/02/05(10:00)
2025,02,04,153384,109786,86322,23464,27.2,2025/02/04(10:00)
2025,02,03,153384,110327,82182,28145,34.2,2025/02/03(18:00)
2025,02,02,153384,105266,65573,39693,60.5,2025/02/02(19:00)
2025,02,01,153384,103451,66483,36968,55.6,2025/02/01(11:00)
2025,01,31,153384,105657,71507,34150,47.8,2025/01/31(11:00)
2025,01,30,153384,104711,63215,41496,65.6,2025/01/30(20:00)
2025,01,29,153384,102670,59700,42970,72,2025/01/29(24:00)
2025,01,28,153384,104279,61947,42332,68.3,2025/01/28(19:00)
2025,01,27,153384,103187,64099,39088,61,2025/01/27(19:00)
2025,01,26,153384,102942,64019,38923,60.8,2025/01/26(19:00)
2025,01,25,153384,103067,65421,37646,57.5,2025/01/25(19:00)
2025,01,24,153384,107854,79724,28130,35.3,2025/01/24(09:00)
2025,01,23,152840,107695,80756,26939,33.4,2025/01/23(09:00)
2025,01,22,152840,108269,80777,27492,34,2025/01/22(10:00)
2025,01,21,152840,107465,81666,25799,31.6,2025/01/21(10:00)
2025,01,20,152840,107787,82082,25705,31.3,2025/01/20(10:00)
2025,01,19,152840,104655,66566,38089,57.2,2025/01/19(19:00)
2025,01,18,152840,104237,68811,35426,51.5,2025/01/18(19:00)
2025,01,17,152840,106929,82514,24415,29.6,2025/01/17(09:00)
2025,01,16,152840,108154,85908,22246,25.9,2025/01/16(10:00)
2025,01,15,152840,107871,83464,24407,29.2,2025/01/15(09:00)
2025,01,14,152827,107160,83831,23329,27.8,2025/01/14(10:00)
2025,01,13,152827,108556,85286,23270,27.3,2025/01/13(10:00)
2025,01,12,152827,105322,70172,35150,50.1,2025/01/12(19:00)
2025,01,11,152827,104834,72458,32376,44.7,2025/01/11(19:00)
2025,01,10,152827,108201,89452,18749,21,2025/01/10(10:00)
2025,01,09,152827,111539,90705,20834,23,2025/01/09(17:00)
2025,01,08,152827,108355,85705,22650,26.4,2025/01/08(10:00)
2025,01,07,152768,110439,84067,26372,31.4,2025/01/07(10:00)
2025,01,06,152768,109592,83402,26190,31.4,2025/01/06(11:00)
2025,01,05,152768,104753,67984,36769,54.1,2025/01/05(19:00)
2025,01,04,152768,104992,68094,36898,54.2,2025/01/04(19:00)
2025,01,03,152768,109392,80523,28869,35.9,2025/01/03(09:00)
2025,01,02,152768,107644,77832,29812,38.3,2025/01/02(09:00)
2025,01,01,152768,106640,64403,42237,65.6,2025/01/01(19:00)
2024,12,31,153071,107481,74743,32738,43.8,2024/12/31(09:00)
2024,12,30,153071,109425,79015,30410,38.5,2024/12/30(10:00)
2024,12,29,153071,107042,66449,40593,61.1,2024/12/29(19:00)
2024,12,28,153071,103371,68926,34445,50,2024/12/28(19:00)
2024,12,27,153071,109010,81190,27820,34.3,2024/12/27(09:00)
2024,12,26,153071,108778,80251,28527,35.5,2024/12/26(10:00)
2024,12,25,153047,104570,69280,35290,50.9,2024/12/25(19:00)
2024,12,24,153047,105243,82612,22631,27.4,2024/12/24(09:00)
2024,12,23,153047,106073,82905,23168,27.9,2024/12/23(10:00)
2024,12,22,153047,103668,68638,35030,51,2024/12/22(19:00)
2024,12,21,153047,103228,69530,33698,48.5,2024/12/21(18:00)
2024,12,20,153047,108789,82424,26365,32,2024/12/20(10:00)
2024,12,19,153047,106287,83314,22973,27.6,2024/12/19(09:00)
2024,12,18,153047,107106,82457,24649,29.9,2024/12/18(18:00)
2024,12,17,152833,108091,81060,27031,33.3,2024/12/17(09:00)
2024,12,16,152833,106749,81607,25142,30.8,2024/12/16(17:00)
2024,12,15,152833,103405,66671,36734,55.1,2024/12/15(19:00)
2024,12,14,152833,104957,68123,36834,54.1,2024/12/14(19:00)
2024,12,13,152833,106738,81020,25718,31.7,2024/12/13(10:00)
2024,12,12,152833,102817,79296,23521,29.7,2024/12/12(09:00)
2024,12,11,152833,102231,79778,22453,28.1,2024/12/11(10:00)
2024,12,10,152821,101819,78819,23000,29.2,2024/12/10(09:00)
2024,12,09,152821,102572,79009,23563,29.8,2024/12/09(18:00)
2024,12,08,152821,99544,65834,33710,51.2,2024/12/08(19:00)
2024,12,07,152821,97949,65961,31988,48.5,2024/12/07(19:00)
2024,12,06,152821,103473,75454,28019,37.1,2024/12/06(18:00)
2024,12,05,152821,103447,76375,27072,35.4,2024/12/05(09:00)
2024,12,04,152821,104115,76065,28050,36.9,2024/12/04(09:00)
2024,12,03,152821,104117,77669,26448,34.1,2024/12/03(18:00)
2024,12,02,152821,102942,74384,28558,38.4,2024/12/02(18:00)
2024,12,01,152821,98520,62792,35728,56.9,2024/12/01(19:00)
2024,11,30,151707,96624,63782,32842,51.5,2024/11/30(19:00)
2024,11,29,151707,97786,76785,21001,27.4,2024/11/29(17:00)
2024,11,28,151707,97527,77085,20442,26.5,2024/11/28(17:00)
2024,11,27,151707,97490,79064,18426,23.3,2024/11/27(11:00)
2024,11,26,151694,95279,74829,20450,27.3,2024/11/26(18:00)
2024,11,25,151694,94787,71647,23140,32.3,2024/11/25(18:00)
2024,11,24,151694,93637,61350,32287,52.6,2024/11/24(19:00)
2024,11,23,151694,94875,62101,32774,52.8,2024/11/23(19:00)
2024,11,22,151694,98393,70524,27869,39.5,2024/11/22(18:00)
2024,11,21,151694,96478,71709,24769,34.5,2024/11/21(18:00)
2024,11,20,151694,96669,72295,24374,33.7,2024/11/20(17:00)
2024,11,19,151393,97701,72232,25469,35.3,2024/11/19(18:00)
2024,11,18,151393,98362,72217,26145,36.2,2024/11/18(18:00)
2024,11,17,151393,95732,60350,35382,58.6,2024/11/17(19:00)
2024,11,16,151393,94226,60205,34021,56.5,2024/11/16(19:00)
2024,11,15,151393,93740,67652,26088,38.6,2024/11/15(09:00)
2024,11,14,151393,93134,69516,23618,34,2024/11/14(17:00)
2024,11,13,151393,93814,67459,26355,39.1,2024/11/13(18:00)
2024,11,12,151350,88130,67979,20151,29.6,2024/11/12(18:00)
2024,11,11,151350,88155,67759,20396,30.1,2024/11/11(19:00)
2024,11,10,151350,85766,59260,26506,44.7,2024/11/10(19:00)
2024,11,09,151350,88152,59156,28996,49,2024/11/09(19:00)
2024,11,08,151350,92529,67692,24837,36.7,2024/11/08(18:00)
2024,11,07,151350,94440,69485,24955,35.9,2024/11/07(19:00)
2024,11,06,151350,94399,68529,25870,37.8,2024/11/06(19:00)
2024,11,05,151317,94568,68166,26402,38.7,2024/11/05(19:00)
2024,11,04,151317,92403,68524,23879,34.8,2024/11/04(19:00)
2024,11,03,151317,90571,59190,31381,53,2024/11/03(19:00)
2024,11,02,151317,87570,59538,28032,47.1,2024/11/02(19:00)
2024,11,01,151317,87175,68839,18336,26.6,2024/11/01(16:00)
2024,10,31,151317,93150,68949,24201,35.1,2024/10/31(19:00)
2024,10,30,151317,92616,68664,23952,34.9,2024/10/30(19:00)
2024,10,29,151317,91605,69236,22369,32.3,2024/10/29(19:00)
2024,10,28,150122,90947,69316,21631,31.2,2024/10/28(19:00)
2024,10,27,150122,88601,59386,29215,49.2,2024/10/27(19:00)
2024,10,26,150122,88347,59839,28508,47.6,2024/10/26(19:00)
2024,10,25,150122,88681,68375,20306,29.7,2024/10/25(19:00)
2024,10,24,150122,89853,69778,20075,28.8,2024/10/24(19:00)
2024,10,23,150122,90089,69492,20597,29.6,2024/10/23(19:00)
2024,10,22,150122,86681,72124,14557,20.2,2024/10/22(17:00)
2024,10,21,150122,87123,70223,16900,24.1,2024/10/21(19:00)
2024,10,20,150122,87860,59093,28767,48.7,2024/10/20(19:00)
2024,10,19,150122,87723,61197,26526,43.3,2024/10/19(19:00)
2024,10,18,150122,85542,71869,13673,19,2024/10/18(17:00)
2024,10,17,150122,87347,71412,15935,22.3,2024/10/17(19:00)
2024,10,16,150122,86708,70903,15805,22.3,2024/10/16(19:00)
2024,10,15,150118,85391,72272,13119,18.2,2024/10/15(19:00)
2024,10,14,150118,83468,71337,12131,17,2024/10/14(17:00)
2024,10,13,150118,86016,59682,26334,44.1,2024/10/13(19:00)
2024,10,12,150118,84361,60197,24164,40.1,2024/10/12(19:00)
2024,10,11,150118,86591,68580,18011,26.3,2024/10/11(19:00)
2024,10,10,150118,84361,71339,13022,18.3,2024/10/10(19:00)
2024,10,09,149907,84474,65676,18798,28.6,2024/10/09(19:00)
2024,10,08,149907,86086,70133,15953,22.7,2024/10/08(19:00)
2024,10,07,149907,85233,70285,14948,21.3,2024/10/07(19:00)
2024,10,06,149907,83442,60269,23173,38.4,2024/10/06(19:00)
2024,10,05,149907,83760,60131,23629,39.3,2024/10/05(19:00)
2024,10,04,149907,86497,66048,20449,31,2024/10/04(19:00)
2024,10,03,149907,87199,64581,22618,35,2024/10/03(19:00)
2024,10,02,149907,89782,67385,22397,33.2,2024/10/02(19:00)
2024,10,01,149907,89380,66345,23035,34.7,2024/10/01(19:00)
2024,09,30,149907,87702,74029,13673,18.5,2024/09/30(18:00)
2024,09,29,149637,87245,63092,24153,38.3,2024/09/29(19:00)
2024,09,28,149637,86418,64871,21547,33.2,2024/09/28(19:00)
2024,09,27,149637,87947,74594,13353,17.9,2024/09/27(17:00)
2024,09,26,149637,90983,76973,14010,18.2,2024/09/26(17:00)
2024,09,25,149637,90539,75063,15476,20.6,2024/09/25(19:00)
2024,09,24,149625,90426,73547,16879,22.9,2024/09/24(19:00)
2024,09,23,149625,94239,72500,21739,30,2024/09/23(19:00)
2024,09,22,149625,92958,63076,29882,47.4,2024/09/22(20:00)
2024,09,21,149625,91824,67880,23944,35.3,2024/09/21(11:00)
2024,09,20,149625,96825,87933,8892,10.1,2024/09/20(11:00)
2024,09,19,149625,98202,88237,9965,11.3,2024/09/19(17:00)
2024,09,18,149625,92453,74274,18179,24.5,2024/09/18(20:00)
2024,09,17,149625,93119,68290,24829,36.4,2024/09/17(20:00)
2024,09,16,149625,93608,68399,25209,36.9,2024/09/16(20:00)
2024,09,15,149625,92253,72823,19430,26.7,2024/09/15(19:00)
2024,09,14,149625,91963,76464,15499,20.3,2024/09/14(20:00)
2024,09,13,149625,98808,85664,13144,15.3,2024/09/13(19:00)
2024,09,12,149625,101837,89018,12819,14.4,2024/09/12(17:00)
2024,09,11,149625,101806,93246,8560,9.2,2024/09/11(17:00)
2024,09,10,149408,101665,93085,8580,9.2,2024/09/10(18:00)
2024,09,09,149408,98561,90240,8321,9.2,2024/09/09(18:00)
2024,09,08,149408,91271,74309,16962,22.8,2024/09/08(20:00)
2024,09,07,149408,91055,74180,16875,22.7,2024/09/07(20:00)
2024,09,06,149408,100137,84423,15714,18.6,2024/09/06(11:00)
2024,09,05,149408,100875,87371,13504,15.5,2024/09/05(17:00)
2024,09,04,149408,100124,85207,14917,17.5,2024/09/04(18:00)
2024,09,03,149390,100524,84302,16222,19.2,2024/09/03(18:00)
2024,09,02,149390,101382,84912,16470,19.4,2024/09/02(17:00)
2024,09,01,149390,98457,73547,24910,33.9,2024/09/01(20:00)
2024,08,31,149390,97775,76281,21494,28.2,2024/08/31(20:00)
2024,08,30,149390,102071,88156,13915,15.8,2024/08/30(18:00)
2024,08,29,149390,103036,89132,13904,15.6,2024/08/29(18:00)
2024,08,28,149390,102147,87061,15086,17.3,2024/08/28(19:00)
2024,08,27,149185,103460,87744,15716,17.9,2024/08/27(17:00)
2024,08,26,149185,103848,92012,11836,12.9,2024/08/26(17:00)
2024,08,25,149185,98571,78726,19845,25.2,2024/08/25(20:00)
2024,08,24,149185,98116,80368,17748,22.1,2024/08/24(20:00)
2024,08,23,149185,102426,90221,12205,13.5,2024/08/23(17:00)
2024,08,22,149185,104705,93224,11481,12.3,2024/08/22(17:00)
2024,08,21,149185,105236,92623,12613,13.6,2024/08/21(17:00)
2024,08,20,149179,105360,97115,8245,8.5,2024/08/20(17:00)
2024,08,19,149179,104640,95611,9029,9.4,2024/08/19(18:00)
2024,08,18,149179,99544,80336,19208,23.9,2024/08/18(20:00)
2024,08,17,149179,98079,80794,17285,21.4,2024/08/17(20:00)
2024,08,16,149179,101278,90358,10920,12.1,2024/08/16(17:00)
2024,08,15,149179,100113,85140,14973,17.6,2024/08/15(20:00)
2024,08,14,149179,103319,93508,9811,10.5,2024/08/14(17:00)
2024,08,13,149177,104764,94639,10125,10.7,2024/08/13(18:00)
2024,08,12,149177,102844,94489,8355,8.8,2024/08/12(19:00)
2024,08,11,149177,99610,81183,18427,22.7,2024/08/11(20:00)
2024,08,10,149177,99138,81106,18032,22.2,2024/08/10(20:00)
2024,08,09,149177,103571,89962,13609,15.1,2024/08/09(18:00)
2024,08,08,149177,102596,90615,11981,13.2,2024/08/08(18:00)
2024,08,07,149177,102219,92326,9893,10.7,2024/08/07(19:00)
2024,08,06,149151,101916,91799,10117,11,2024/08/06(19:00)
2024,08,05,149151,102310,93841,8469,9,2024/08/05(17:00)
2024,08,04,149151,97228,81926,15302,18.7,2024/08/04(20:00)
2024,08,03,149151,96672,80942,15730,19.4,2024/08/03(20:00)
2024,08,02,149151,99899,85301,14598,17.1,2024/08/02(19:00)
2024,08,01,149151,96211,85215,10996,12.9,2024/08/01(20:00)
2024,07,31,149151,96018,84794,11224,13.2,2024/07/31(19:00)
2024,07,30,148932,96704,84530,12174,14.4,2024/07/30(19:00)
2024,07,29,148932,96042,82616,13426,16.3,2024/07/29(19:00)
2024,07,28,148932,95923,76431,19492,25.5,2024/07/28(20:00)
2024,07,27,148932,94695,77483,17212,22.2,2024/07/27(20:00)
2024,07,26,148932,99785,88660,11125,12.5,2024/07/26(16:00)
2024,07,25,148932,99162,90254,8908,9.9,2024/07/25(17:00)
2024,07,24,148932,100266,87552,12714,14.5,2024/07/24(17:00)
2024,07,23,148917,99079,87645,11434,13,2024/07/23(17:00)
2024,07,22,148917,100373,86921,13452,15.5,2024/07/22(19:00)
2024,07,21,148917,98147,74740,23407,31.3,2024/07/21(20:00)
2024,07,20,148917,98911,74657,24254,32.5,2024/07/20(20:00)
2024,07,19,148917,96173,82174,13999,17,2024/07/19(11:00)
2024,07,18,148917,98615,84567,14048,16.6,2024/07/18(11:00)
2024,07,17,148917,99597,84204,15393,18.3,2024/07/17(17:00)
2024,07,16,148912,98716,83678,15038,18,2024/07/16(15:00)
2024,07,15,148912,100094,82759,17335,20.9,2024/07/15(17:00)
2024,07,14,148912,95453,69336,26117,37.7,2024/07/14(20:00)
2024,07,13,148912,96929,71353,25576,35.8,2024/07/13(20:00)
2024,07,12,148912,97623,78463,19160,24.4,2024/07/12(19:00)
2024,07,11,148912,98172,79983,18189,22.7,2024/07/11(17:00)
2024,07,10,148912,97872,80964,16908,20.9,2024/07/10(17:00)
2024,07,09,148897,97233,82246,14987,18.2,2024/07/09(11:00)
2024,07,08,148897,96391,83021,13370,16.1,2024/07/08(11:00)
2024,07,07,148897,93120,70129,22991,32.8,2024/07/07(20:00)
2024,07,06,148897,93120,72015,21105,29.3,2024/07/06(20:00)
2024,07,05,148897,95500,77102,18398,23.9,2024/07/05(19:00)
2024,07,04,148897,95812,81970,13842,16.9,2024/07/04(19:00)
2024,07,03,148897,95509,77555,17954,23.2,2024/07/03(20:00)
2024,07,02,148709,95711,79801,15910,19.9,2024/07/02(11:00)
2024,07,01,148709,95058,78373,16685,21.3,2024/07/01(19:00)
2024,06,30,148709,92841,65856,26985,41,2024/06/30(20:00)
2024,06,29,148089,88692,68360,20332,29.7,2024/06/29(19:00)
2024,06,28,148089,89229,74741,14488,19.4,2024/06/28(19:00)
2024,06,27,148089,92041,76144,15897,20.9,2024/06/27(17:00)
2024,06,26,148089,93282,74719,18563,24.8,2024/06/26(19:00)
2024,06,25,148089,91673,73022,18651,25.5,2024/06/25(19:00)
2024,06,24,148089,91515,76628,14887,19.4,2024/06/24(17:00)
2024,06,23,148089,86778,66868,19910,29.8,2024/06/23(21:00)
2024,06,22,148089,84914,68355,16559,24.2,2024/06/22(12:00)
2024,06,21,148089,91016,77749,13267,17.1,2024/06/21(17:00)
2024,06,20,148089,89378,79731,9647,12.1,2024/06/20(17:00)
2024,06,19,148089,89170,80077,9093,11.4,2024/06/19(18:00)
2024,06,18,148084,87447,76826,10621,13.8,2024/06/18(19:00)
2024,06,17,148084,86828,73958,12870,17.4,2024/06/17(17:00)
2024,06,16,148084,81459,63577,17882,28.1,2024/06/16(21:00)
2024,06,15,148084,83230,66114,17116,25.9,2024/06/15(20:00)
2024,06,14,148084,86901,75619,11282,14.9,2024/06/14(17:00)
2024,06,13,148084,85470,76144,9326,12.2,2024/06/13(19:00)
2024,06,12,148084,84347,74251,10096,13.6,2024/06/12(18:00)
2024,06,11,148013,85597,74244,11353,15.3,2024/06/11(17:00)
2024,06,10,148013,83154,72134,11020,15.3,2024/06/10(20:00)
2024,06,09,148013,80290,60934,19356,31.8,2024/06/09(21:00)
2024,06,08,148013,78011,60509,17502,28.9,2024/06/08(21:00)
2024,06,07,148013,81430,67558,13872,20.5,2024/06/07(19:00)
2024,06,06,148013,82299,65329,16970,26,2024/06/06(20:00)
2024,06,05,148013,82374,69421,12953,18.7,2024/06/05(17:00)
2024,06,04,148010,82534,69279,13255,19.1,2024/06/04(20:00)
2024,06,03,148010,83320,68493,14827,21.6,2024/06/03(19:00)
2024,06,02,148010,80914,58661,22253,37.9,2024/06/02(21:00)
2024,06,01,148010,80669,59085,21584,36.5,2024/06/01(21:00)
2024,05,31,148010,81185,66428,14757,22.2,2024/05/31(20:00)
2024,05,30,148010,81392,69571,11821,17,2024/05/30(17:00)
2024,05,29,148010,81388,68823,12565,18.3,2024/05/29(20:00)
2024,05,28,147999,80711,68694,12017,17.5,2024/05/28(20:00)
2024,05,27,147999,81417,67126,14291,21.3,2024/05/27(20:00)
2024,05,26,147999,81935,59436,22499,37.9,2024/05/26(20:00)
2024,05,25,147999,81428,59700,21728,36.4,2024/05/25(20:00)
2024,05,24,147999,83976,67481,16495,24.4,2024/05/24(20:00)
2024,05,23,147999,82585,69899,12686,18.1,2024/05/23(20:00)
2024,05,22,147999,82015,68837,13178,19.1,2024/05/22(20:00)
2024,05,21,147824,81608,69074,12534,18.1,2024/05/21(20:00)
2024,05,20,147824,81523,68764,12759,18.6,2024/05/20(20:00)
2024,05,19,147824,81405,58903,22502,38.2,2024/05/19(21:00)
2024,05,18,147824,80001,58755,21246,36.2,2024/05/18(21:00)
2024,05,17,147824,84810,64407,20403,31.7,2024/05/17(20:00)
2024,05,16,146781,84251,65411,18840,28.8,2024/05/16(20:00)
2024,05,15,146781,84159,61854,22305,36.1,2024/05/15(20:00)
2024,05,14,146781,82838,66155,16683,25.2,2024/05/14(20:00)
2024,05,13,146781,82781,66062,16719,25.3,2024/05/13(20:00)
2024,05,12,146781,83874,57019,26855,47.1,2024/05/12(21:00)
2024,05,11,146781,81666,60042,21624,36,2024/05/11(20:00)
2024,05,10,146781,84637,65342,19295,29.5,2024/05/10(20:00)
2024,05,09,146781,84188,66481,17707,26.6,2024/05/09(20:00)
2024,05,08,146769,83781,65047,18734,28.8,2024/05/08(20:00)
2024,05,07,146769,82553,67765,14788,21.8,2024/05/07(17:00)
2024,05,06,146769,79868,60134,19734,32.8,2024/05/06(20:00)
2024,05,05,146769,79862,57151,22711,39.7,2024/05/05(20:00)
2024,05,04,146769,80783,57871,22912,39.6,2024/05/04(20:00)
2024,05,03,146769,83940,65403,18537,28.3,2024/05/03(20:00)
2024,05,02,146769,85106,66858,18248,27.3,2024/05/02(20:00)
2024,05,01,146769,84183,60711,23472,38.7,2024/05/01(20:00)
2024,04,30,146804,84692,66065,18627,28.2,2024/04/30(20:00)
2024,04,29,146804,82388,67228,15160,22.6,2024/04/29(19:00)
2024,04,28,146804,82956,58003,24953,43,2024/04/28(20:00)
2024,04,27,146804,82586,57999,24587,42.4,2024/04/27(20:00)
2024,04,26,146804,82938,65026,17912,27.5,2024/04/26(20:00)
2024,04,25,146804,84577,66552,18025,27.1,2024/04/25(20:00)
2024,04,24,146804,84100,66215,17885,27,2024/04/24(20:00)
2024,04,23,146648,83431,66991,16440,24.5,2024/04/23(20:00)
2024,04,22,146648,81352,66727,14625,21.9,2024/04/22(20:00)
2024,04,21,146648,80579,58279,22300,38.3,2024/04/21(20:00)
2024,04,20,146648,81025,59338,21687,36.5,2024/04/20(20:00)
2024,04,19,146648,85986,65136,20850,32,2024/04/19(20:00)
2024,04,18,146648,86846,66740,20106,30.1,2024/04/18(20:00)
2024,04,17,146648,86950,66182,20768,31.4,2024/04/17(20:00)
2024,04,16,146634,86462,67321,19141,28.4,2024/04/16(20:00)
2024,04,15,146634,86527,68634,17893,26.1,2024/04/15(11:00)
2024,04,14,146634,84810,58115,26695,45.9,2024/04/14(20:00)
2024,04,13,146634,84897,58314,26583,45.6,2024/04/13(20:00)
2024,04,12,146634,87005,64816,22189,34.2,2024/04/12(20:00)
2024,04,11,146634,87821,66663,21158,31.7,2024/04/11(20:00)
2024,04,10,146634,89416,62161,27255,43.8,2024/04/10(20:00)
2024,04,09,146634,89521,66950,22571,33.7,2024/04/09(20:00)
2024,04,08,146634,86350,67383,18967,28.1,2024/04/08(20:00)
2024,04,07,146634,85279,57502,27777,48.3,2024/04/07(20:00)
2024,04,06,146634,85887,58937,26950,45.7,2024/04/06(20:00)
2024,04,05,146634,87037,65933,21104,32,2024/04/05(20:00)
2024,04,04,145191,84160,68151,16009,23.5,2024/04/04(20:00)
2024,04,03,145191,83155,71199,11956,16.8,2024/04/03(11:00)
2024,04,02,145175,85029,67742,17287,25.5,2024/04/02(20:00)
2024,04,01,145175,86473,67349,19124,28.4,2024/04/01(20:00)
2024,03,31,145175,80988,58369,22619,38.8,2024/03/31(20:00)
2024,03,30,145175,83827,60199,23628,39.2,2024/03/30(20:00)
2024,03,29,145175,88279,69967,18312,26.2,2024/03/29(14:00)
2024,03,28,145175,86289,75842,10447,13.8,2024/03/28(11:00)
2024,03,27,145175,87771,69829,17942,25.7,2024/03/27(20:00)
2024,03,26,145162,87608,74182,13426,18.1,2024/03/26(10:00)
2024,03,25,145162,86170,72997,13173,18,2024/03/25(17:00)
2024,03,24,145162,81739,59839,21900,36.6,2024/03/24(20:00)
2024,03,23,145162,82122,60972,21150,34.7,2024/03/23(20:00)
2024,03,22,145162,84736,70498,14238,20.2,2024/03/22(17:00)
2024,03,21,145162,87429,72439,14990,20.7,2024/03/21(20:00)
2024,03,20,145162,87216,72438,14778,20.4,2024/03/20(20:00)
2024,03,19,145008,88935,73424,15511,21.1,2024/03/19(09:00)
2024,03,18,145008,88397,71342,17055,23.9,2024/03/18(19:00)
2024,03,17,145008,82789,61659,21130,34.3,2024/03/17(20:00)
2024,03,16,145008,83600,62121,21479,34.6,2024/03/16(20:00)
2024,03,15,145008,89233,70500,18733,26.6,2024/03/15(09:00)
2024,03,14,145008,89106,73172,15934,21.8,2024/03/14(09:00)
2024,03,13,145008,87647,73868,13779,18.7,2024/03/13(09:00)
2024,03,12,145016,91404,78213,13191,16.9,2024/03/12(10:00)
2024,03,11,145016,92202,74908,17294,23.1,2024/03/11(10:00)
2024,03,10,145016,85565,63464,22101,34.8,2024/03/10(20:00)
2024,03,09,145016,86562,65322,21240,32.5,2024/03/09(20:00)
2024,03,08,145016,94887,74464,20423,27.4,2024/03/08(19:00)
2024,03,07,145016,94616,77363,17253,22.3,2024/03/07(10:00)
2024,03,06,145016,94421,75397,19024,25.2,2024/03/06(09:00)
2024,03,05,145013,95500,81691,13809,16.9,2024/03/05(11:00)
2024,03,04,145013,97561,76456,21105,27.6,2024/03/04(09:00)
2024,03,03,145013,94824,64502,30322,47,2024/03/03(20:00)
2024,03,02,145013,97767,66510,31257,47,2024/03/02(20:00)
2024,03,01,145013,98086,70870,27216,38.4,2024/03/01(20:00)
2024,02,29,145013,98139,79171,18968,24,2024/02/29(11:00)
2024,02,28,145013,98589,74394,24195,32.5,2024/02/28(09:00)
2024,02,27,144983,99023,75933,23090,30.4,2024/02/27(09:00)
2024,02,26,144983,97595,74935,22660,30.2,2024/02/26(09:00)
2024,02,25,144983,99547,63998,35549,55.5,2024/02/25(20:00)
2024,02,24,144983,99383,66189,33194,50.2,2024/02/24(19:00)
2024,02,23,144983,102637,81368,21269,26.1,2024/02/23(10:00)
2024,02,22,144983,101921,84093,17828,21.2,2024/02/22(11:00)
2024,02,21,144983,101952,81790,20162,24.7,2024/02/21(11:00)
2024,02,20,144779,100078,79989,20089,25.1,2024/02/20(15:00)
2024,02,19,144779,100165,76849,23316,30.3,2024/02/19(11:00)
2024,02,18,144779,98249,63128,35121,55.6,2024/02/18(20:00)
2024,02,17,144779,99297,64340,34957,54.3,2024/02/17(01:00)
2024,02,16,144779,98981,75965,23016,30.3,2024/02/16(09:00)
2024,02,15,144779,99252,78957,20295,25.7,2024/02/15(15:00)
2024,02,14,144765,99406,75951,23455,30.9,2024/02/14(10:00)
2024,02,13,144765,99200,71718,27482,38.3,2024/02/13(09:00)
2024,02,12,144765,98537,61340,37197,60.6,2024/02/12(20:00)
2024,02,11,144765,100590,58509,42081,71.9,2024/02/11(20:00)
2024,02,10,144765,98681,57179,41502,72.6,2024/02/10(24:00)
2024,02,09,144765,98759,62755,36004,57.4,2024/02/09(01:00)
2024,02,08,144765,101029,77521,23508,30.3,2024/02/08(09:00)
2024,02,07,144765,97216,79115,18101,22.9,2024/02/07(09:00)
2024,02,06,144746,97363,83641,13722,16.4,2024/02/06(10:00)
2024,02,05,144746,97905,82573,15332,18.6,2024/02/05(11:00)
2024,02,04,144746,98483,64807,33676,52,2024/02/04(19:00)
2024,02,03,144746,96458,66832,29626,44.3,2024/02/03(19:00)
2024,02,02,144746,99377,79921,19456,24.3,2024/02/02(10:00)
2024,02,01,144746,97420,81677,15743,19.3,2024/02/01(10:00)
2024,01,31,144746,99286,80671,18615,23.1,2024/01/31(10:00)
2024,01,30,144652,100814,82692,18122,21.9,2024/01/30(09:00)
2024,01,29,144652,101454,82039,19415,23.7,2024/01/29(10:00)
2024,01,28,144652,100740,67741,32999,48.7,2024/01/28(19:00)
2024,01,27,144652,100226,69125,31101,45,2024/01/27(19:00)
2024,01,26,144652,102593,84354,18239,21.6,2024/01/26(09:00)
2024,01,25,144652,104370,86788,17582,20.3,2024/01/25(10:00)
2024,01,24,144652,104666,88055,16611,18.9,2024/01/24(10:00)
2024,01,23,144640,104997,89231,15766,17.7,2024/01/23(17:00)
2024,01,22,144640,104312,86746,17566,20.2,2024/01/22(18:00)
2024,01,21,144640,99278,66867,32411,48.5,2024/01/21(19:00)
2024,01,20,144640,97708,69500,28208,40.6,2024/01/20(11:00)
2024,01,19,144640,101298,81003,20295,25.1,2024/01/19(10:00)
2024,01,18,144640,102314,82978,19336,23.3,2024/01/18(11:00)
2024,01,17,144640,103539,86162,17377,20.2,2024/01/17(11:00)
2024,01,16,144426,104133,83487,20646,24.7,2024/01/16(09:00)
2024,01,15,144426,105880,81436,24444,30,2024/01/15(18:00)
2024,01,14,144426,102984,66854,36130,54,2024/01/14(19:00)
2024,01,13,144426,98104,68211,29893,43.8,2024/01/13(19:00)
2024,01,12,144426,102931,80506,22425,27.9,2024/01/12(09:00)
2024,01,11,144426,103418,84185,19233,22.8,2024/01/11(10:00)
2024,01,10,144426,105583,85081,20502,24.1,2024/01/10(10:00)
2024,01,09,144421,103910,88214,15696,17.8,2024/01/09(11:00)
2024,01,08,144421,105598,84150,21448,25.5,2024/01/08(10:00)
2024,01,07,144421,103720,69798,33922,48.6,2024/01/07(19:00)
2024,01,06,144421,99930,67965,31965,47,2024/01/06(19:00)
2024,01,05,144421,101519,80632,20887,25.9,2024/01/05(10:00)
2024,01,04,144421,101701,81728,19973,24.4,2024/01/04(09:00)
2024,01,03,144415,101197,83422,17775,21.3,2024/01/03(10:00)
2024,01,02,144415,103419,80460,22959,28.5,2024/01/02(10:00)
2024,01,01,144415,101990,63132,38858,61.6,2024/01/01(19:00)
2023,12,31,144415,102709,63589,39120,61.5,2023/12/31(19:00)
2023,12,30,144415,102366,66025,36341,55,2023/12/30(18:00)
2023,12,29,144415,103693,78244,25449,32.5,2023/12/29(09:00)
2023,12,28,144381,102810,81745,21065,25.8,2023/12/28(10:00)
2023,12,27,144381,103064,82383,20681,25.1,2023/12/27(10:00)
2023,12,26,144381,102816,84106,18710,22.2,2023/12/26(10:00)
2023,12,25,144381,103217,71050,32167,45.3,2023/12/25(19:00)
2023,12,24,144381,102110,68643,33467,48.8,2023/12/24(19:00)
2023,12,23,144381,103207,73369,29838,40.7,2023/12/23(19:00)
2023,12,22,144381,104466,91391,13075,14.3,2023/12/22(10:00)
2023,12,21,144381,105213,91556,13657,14.9,2023/12/21(10:00)
2023,12,20,144381,103834,89230,14604,16.4,2023/12/20(17:00)
2023,12,19,144200,101928,88580,13348,15.1,2023/12/19(10:00)
2023,12,18,144200,103366,88869,14497,16.3,2023/12/18(11:00)
2023,12,17,144200,99119,70703,28416,40.2,2023/12/17(19:00)
2023,12,16,144200,99891,70383,29508,41.9,2023/12/16(19:00)
2023,12,15,144200,99963,78513,21450,27.3,2023/12/15(11:00)
2023,12,14,144200,101310,77896,23414,30.1,2023/12/14(15:00)
2023,12,13,144200,101145,75581,25564,33.8,2023/12/13(09:00)
2023,12,12,144070,100804,76995,23809,30.9,2023/12/12(10:00)
2023,12,11,144070,100669,76893,23776,30.9,2023/12/11(15:00)
2023,12,10,144070,96107,61067,35040,57.4,2023/12/10(19:00)
2023,12,09,144070,97556,62483,35073,56.1,2023/12/09(19:00)
2023,12,08,144070,99956,75245,24711,32.8,2023/12/08(09:00)
2023,12,07,144070,100157,77237,22920,29.7,2023/12/07(09:00)
2023,12,06,144070,99399,79102,20297,25.7,2023/12/06(10:00)
2023,12,05,144063,97325,78441,18884,24.1,2023/12/05(09:00)
2023,12,04,144063,99020,79599,19421,24.4,2023/12/04(18:00)
2023,12,03,144063,97827,65368,32459,49.7,2023/12/03(19:00)
2023,12,02,144063,96616,66924,29692,44.4,2023/12/02(01:00)
2023,12,01,144063,99572,81228,18344,22.6,2023/12/01(10:00)
2023,11,30,144063,96366,82716,13650,16.5,2023/11/30(18:00)
2023,11,29,144063,96664,81146,15518,19.1,2023/11/29(17:00)
2023,11,28,144026,96172,78894,17278,21.9,2023/11/28(18:00)
2023,11,27,144026,93206,79861,13345,16.7,2023/11/27(11:00)
2023,11,26,144336,90868,63720,27148,42.6,2023/11/26(19:00)
2023,11,25,144336,91812,66540,25272,38,2023/11/25(19:00)
2023,11,24,144336,97329,76598,20731,27.1,2023/11/24(18:00)
2023,11,23,144336,92817,72557,20260,27.9,2023/11/23(18:00)
2023,11,22,144336,92695,73266,19429,26.5,2023/11/22(18:00)
2023,11,21,143978,91666,74025,17641,23.8,2023/11/21(09:00)
2023,11,20,143978,92492,75162,17330,23.1,2023/11/20(18:00)
2023,11,19,143978,91299,62598,28701,45.8,2023/11/19(19:00)
2023,11,18,143978,91879,66148,25731,38.9,2023/11/18(19:00)
2023,11,17,143978,90313,76618,13695,17.9,2023/11/17(17:00)
2023,11,16,143978,89652,78815,10837,13.7,2023/11/16(15:00)
2023,11,15,143978,89641,73401,16240,22.1,2023/11/15(09:00)
2023,11,14,143802,89441,74305,15136,20.4,2023/11/14(18:00)
2023,11,13,143802,90613,75186,15427,20.5,2023/11/13(18:00)
2023,11,12,143802,90094,63156,26938,42.7,2023/11/12(19:00)
2023,11,11,143802,90025,63124,26901,42.6,2023/11/11(19:00)
2023,11,10,143802,90043,70206,19837,28.3,2023/11/10(19:00)
2023,11,09,143802,88466,69833,18633,26.7,2023/11/09(18:00)
2023,11,08,143802,88768,68456,20312,29.7,2023/11/08(19:00)
2023,11,07,143770,88748,70456,18292,26,2023/11/07(19:00)
2023,11,06,143770,85794,69757,16037,23,2023/11/06(10:00)
2023,11,05,143770,84474,60309,24165,40.1,2023/11/05(19:00)
2023,11,04,143770,86600,61037,25563,41.9,2023/11/04(19:00)
2023,11,03,143770,86921,69323,17598,25.4,2023/11/03(18:00)
2023,11,02,143770,86411,70489,15922,22.6,2023/11/02(19:00)
2023,11,01,143770,84681,69845,14836,21.2,2023/11/01(18:00)
2023,10,31,143731,84749,69878,14871,21.3,2023/10/31(19:00)
2023,10,30,143731,82961,69602,13359,19.2,2023/10/30(19:00)
2023,10,29,143731,82674,58684,23990,40.9,2023/10/29(19:00)
2023,10,28,143731,81318,59753,21565,36.1,2023/10/28(19:00)
2023,10,27,143731,84240,68296,15944,23.3,2023/10/27(19:00)
2023,10,26,143731,83740,70646,13094,18.5,2023/10/26(19:00)
2023,10,25,143731,83979,69653,14326,20.6,2023/10/25(19:00)
2023,10,24,143712,84248,70197,14051,20,2023/10/24(19:00)
2023,10,23,143712,83397,69638,13759,19.8,2023/10/23(19:00)
2023,10,22,143712,85357,58718,26639,45.4,2023/10/22(19:00)
2023,10,21,143712,83506,59888,23618,39.4,2023/10/21(19:00)
2023,10,20,143712,87249,67722,19527,28.8,2023/10/20(19:00)
2023,10,19,143712,85738,70985,14753,20.8,2023/10/19(19:00)
2023,10,18,143712,86240,69700,16540,23.7,2023/10/18(19:00)
2023,10,17,143559,84574,69960,14614,20.9,2023/10/17(19:00)
2023,10,16,143559,85263,69274,15989,23.1,2023/10/16(19:00)
2023,10,15,143559,83060,59651,23409,39.2,2023/10/15(19:00)
2023,10,14,143559,82270,60838,21432,35.2,2023/10/14(19:00)
2023,10,13,143559,84971,69448,15523,22.4,2023/10/13(19:00)
2023,10,12,143559,84165,70840,13325,18.8,2023/10/12(19:00)
2023,10,11,143486,84960,70443,14517,20.6,2023/10/11(19:00)
2023,10,10,143486,85494,70604,14890,21.1,2023/10/10(19:00)
2023,10,09,143486,86123,63732,22391,35.1,2023/10/09(19:00)
2023,10,08,143486,87772,58651,29121,49.7,2023/10/08(19:00)
2023,10,07,143486,88103,60894,27209,44.7,2023/10/07(19:00)
2023,10,06,143486,89340,68442,20898,30.5,2023/10/06(19:00)
2023,10,05,143486,88648,68749,19899,28.9,2023/10/05(19:00)
2023,10,04,143486,87361,70315,17046,24.2,2023/10/04(19:00)
2023,10,03,143486,88991,61368,27623,45,2023/10/03(19:00)
2023,10,02,143486,89665,57484,32181,56,2023/10/02(19:00)
2023,10,01,143486,88085,54323,33762,62.2,2023/10/01(20:00)
2023,09,30,143486,87107,54122,32985,60.9,2023/09/30(20:00)
2023,09,29,143486,89759,52425,37334,71.2,2023/09/29(20:00)
2023,09,28,143486,92297,56740,35557,62.7,2023/09/28(19:00)
2023,09,27,143486,91105,71537,19568,27.4,2023/09/27(11:00)
2023,09,26,143481,89883,74562,15321,20.5,2023/09/26(17:00)
2023,09,25,143481,90962,74249,16713,22.5,2023/09/25(17:00)
2023,09,24,143481,87899,61853,26046,42.1,2023/09/24(20:00)
2023,09,23,143481,88758,63395,25363,40,2023/09/23(20:00)
2023,09,22,143481,92123,71935,20188,28.1,2023/09/22(19:00)
2023,09,21,143481,92647,74465,18182,24.4,2023/09/21(17:00)
2023,09,20,143481,91763,79940,11823,14.8,2023/09/20(11:00)
2023,09,19,143460,91780,79704,12076,15.2,2023/09/19(17:00)
2023,09,18,143460,94611,79866,14745,18.5,2023/09/18(18:00)
2023,09,17,143460,92366,67762,24604,36.3,2023/09/17(20:00)
2023,09,16,143460,89463,69043,20420,29.6,2023/09/16(15:00)
2023,09,15,143460,94430,78139,16291,20.8,2023/09/15(17:00)
2023,09,14,143460,94930,80149,14781,18.4,2023/09/14(17:00)
2023,09,13,143460,94349,81364,12985,16,2023/09/13(11:00)
2023,09,12,143429,96217,82478,13739,16.7,2023/09/12(17:00)
2023,09,11,143429,97469,81913,15556,19,2023/09/11(18:00)
2023,09,10,143429,95818,68207,27611,40.5,2023/09/10(20:00)
2023,09,09,143429,94923,69152,25771,37.3,2023/09/09(20:00)
2023,09,08,143429,98050,78754,19296,24.5,2023/09/08(18:00)
2023,09,07,143429,98334,81665,16669,20.4,2023/09/07(18:00)
2023,09,06,143429,98686,84181,14505,17.2,2023/09/06(18:00)
2023,09,05,143401,99391,85682,13709,16,2023/09/05(18:00)
2023,09,04,143401,99186,85567,13619,15.9,2023/09/04(17:00)
2023,09,03,143401,98099,70303,27796,39.5,2023/09/03(20:00)
2023,09,02,143401,97506,68954,28552,41.4,2023/09/02(20:00)
2023,09,01,143401,100172,76397,23775,31.1,2023/09/01(18:00)
2023,08,31,143401,101698,77880,23818,30.6,2023/08/31(19:00)
2023,08,30,143401,101752,81190,20562,25.3,2023/08/30(11:00)
2023,08,29,143332,102207,83947,18260,21.8,2023/08/29(15:00)
2023,08,28,143332,102236,81578,20658,25.3,2023/08/28(17:00)
2023,08,27,143332,96857,71334,25523,35.8,2023/08/27(20:00)
2023,08,26,143332,98457,71966,26491,36.8,2023/08/26(20:00)
2023,08,25,143332,102355,82632,19723,23.9,2023/08/25(18:00)
2023,08,24,143332,102384,86561,15823,18.3,2023/08/24(16:00)
2023,08,23,143332,103456,87971,15485,17.6,2023/08/23(17:00)
2023,08,22,143332,104034,90322,13712,15.2,2023/08/22(17:00)
2023,08,21,143332,102587,91334,11253,12.3,2023/08/21(18:00)
2023,08,20,143332,100227,76867,23360,30.4,2023/08/20(20:00)
2023,08,19,142584,101346,77513,23833,30.7,2023/08/19(20:00)
2023,08,18,142584,102810,88570,14240,16.1,2023/08/18(17:00)
2023,08,17,142584,102798,86794,16004,18.4,2023/08/17(18:00)
2023,08,16,142584,102713,86140,16573,19.2,2023/08/16(17:00)
2023,08,15,142584,102421,80630,21791,27,2023/08/15(20:00)
2023,08,14,142584,102576,82760,19816,23.9,2023/08/14(18:00)
2023,08,13,142584,99087,72148,26939,37.3,2023/08/13(20:00)
2023,08,12,142584,99351,69688,29663,42.6,2023/08/12(20:00)
2023,08,11,142584,103881,80549,23332,29,2023/08/11(17:00)
2023,08,10,142584,102841,81651,21190,26,2023/08/10(11:00)
2023,08,09,142584,103773,89935,13838,15.4,2023/08/09(15:00)
2023,08,08,142567,103860,93299,10561,11.3,2023/08/08(18:00)
2023,08,07,142567,104297,93615,10682,11.4,2023/08/07(17:00)
2023,08,06,142567,101793,79971,21822,27.3,2023/08/06(20:00)
2023,08,05,142567,101731,80221,21510,26.8,2023/08/05(20:00)
2023,08,04,142567,101133,86089,15044,17.5,2023/08/04(19:00)
2023,08,03,142567,101997,85990,16007,18.6,2023/08/03(19:00)
2023,08,02,142567,102567,82699,19868,24,2023/08/02(19:00)
2023,08,01,142567,101734,82962,18772,22.6,2023/08/01(20:00)
2023,07,31,142567,101789,80734,21055,26.1,2023/07/31(19:00)
2023,07,30,142567,100571,74605,25966,34.8,2023/07/30(20:00)
2023,07,29,142567,99446,76405,23041,30.2,2023/07/29(20:00)
2023,07,28,142567,102152,85321,16831,19.7,2023/07/28(17:00)
2023,07,27,142201,102234,87033,15201,17.5,2023/07/27(18:00)
2023,07,26,142201,103142,86054,17088,19.9,2023/07/26(17:00)
2023,07,25,142201,103526,83943,19583,23.3,2023/07/25(17:00)
2023,07,24,142201,102648,83062,19586,23.6,2023/07/24(17:00)
2023,07,23,142201,99820,70370,29450,41.9,2023/07/23(20:00)
2023,07,22,142201,99735,72220,27515,38.1,2023/07/22(15:00)
2023,07,21,142201,103301,84221,19080,22.7,2023/07/21(17:00)
2023,07,20,142201,104568,83731,20837,24.9,2023/07/20(17:00)
2023,07,19,142201,103424,80874,22550,27.9,2023/07/19(19:00)
2023,07,18,142126,101987,82615,19372,23.4,2023/07/18(15:00)
2023,07,17,142126,102562,82555,20007,24.2,2023/07/17(17:00)
2023,07,16,142126,95585,68041,27544,40.5,2023/07/16(20:00)
2023,07,15,142126,94588,70903,23685,33.4,2023/07/15(12:00)
2023,07,14,142126,98278,84380,13898,16.5,2023/07/14(11:00)
2023,07,13,142126,98496,84575,13921,16.5,2023/07/13(11:00)
2023,07,12,142126,99381,82046,17335,21.1,2023/07/12(17:00)
2023,07,11,141984,98896,83533,15363,18.4,2023/07/11(11:00)
2023,07,10,141984,99558,82203,17355,21.1,2023/07/10(18:00)
2023,07,09,141984,95134,68423,26711,39,2023/07/09(20:00)
2023,07,08,141984,94216,69633,24583,35.3,2023/07/08(20:00)
2023,07,07,141984,96783,82068,14715,17.9,2023/07/07(14:00)
2023,07,06,141984,99885,82268,17617,21.4,2023/07/06(17:00)
2023,07,05,141984,98922,77283,21639,28,2023/07/05(19:00)
2023,07,04,140955,97789,83089,14700,17.7,2023/07/04(15:00)
2023,07,03,140955,98483,84023,14460,17.2,2023/07/03(17:00)
2023,07,02,140955,95689,69809,25880,37.1,2023/07/02(20:00)
2023,07,01,140955,95423,69581,25842,37.1,2023/07/01(20:00)
2023,06,30,140955,93460,79294,14166,17.9,2023/06/30(11:00)
2023,06,29,140955,93562,82196,11366,13.8,2023/06/29(11:00)
2023,06,28,140945,94576,79205,15371,19.4,2023/06/28(17:00)
2023,06,27,140945,93711,77801,15910,20.4,2023/06/27(19:00)
2023,06,26,140945,93188,79558,13630,17.1,2023/06/26(17:00)
2023,06,25,140945,86380,66484,19896,29.9,2023/06/25(20:00)
2023,06,24,140945,88311,66496,21815,32.8,2023/06/24(20:00)
2023,06,23,140945,90105,73677,16428,22.3,2023/06/23(18:00)
2023,06,22,140945,90532,73402,17130,23.3,2023/06/22(19:00)
2023,06,21,140945,90548,75890,14658,19.3,2023/06/21(11:00)
2023,06,20,140908,91012,76566,14446,18.9,2023/06/20(15:00)
2023,06,19,140908,91145,79351,11794,14.9,2023/06/19(17:00)
2023,06,18,140908,84025,64094,19931,31.1,2023/06/18(20:00)
2023,06,17,140908,83897,63664,20233,31.8,2023/06/17(20:00)
2023,06,16,140908,85483,72163,13320,18.5,2023/06/16(18:00)
2023,06,15,140908,84221,72139,12082,16.7,2023/06/15(19:00)
2023,06,14,140908,86792,71475,15317,21.4,2023/06/14(17:00)
2023,06,13,140758,86678,72258,14420,20,2023/06/13(19:00)
2023,06,12,140758,87631,71512,16119,22.5,2023/06/12(18:00)
2023,06,11,140758,82473,62339,20134,32.3,2023/06/11(21:00)
2023,06,10,140758,82997,61953,21044,34,2023/06/10(21:00)
2023,06,09,140758,83619,69747,13872,19.9,2023/06/09(19:00)
2023,06,08,140758,85279,70755,14524,20.5,2023/06/08(17:00)
2023,06,07,140758,85092,69540,15552,22.4,2023/06/07(20:00)
2023,06,06,140758,86513,63781,22732,35.6,2023/06/06(21:00)
2023,06,05,140758,84710,65659,19051,29,2023/06/05(20:00)
2023,06,04,140758,84682,59372,25310,42.6,2023/06/04(21:00)
2023,06,03,140758,82672,59502,23170,38.9,2023/06/03(21:00)
2023,06,02,140758,82669,68262,14407,21.1,2023/06/02(19:00)
2023,06,01,140758,83644,71202,12442,17.5,2023/06/01(17:00)
2023,05,31,140240,83165,69289,13876,20,2023/05/31(19:00)
2023,05,30,140240,82332,72772,9560,13.1,2023/05/30(17:00)
2023,05,29,140240,79383,65013,14370,22.1,2023/05/29(20:00)
2023,05,28,140240,79202,59003,20199,34.2,2023/05/28(20:00)
2023,05,27,140240,82676,60765,21911,36.1,2023/05/27(21:00)
2023,05,26,140240,84268,68018,16250,23.9,2023/05/26(17:00)
2023,05,25,140240,83621,68519,15102,22,2023/05/25(17:00)
2023,05,24,140240,81333,67877,13456,19.8,2023/05/24(17:00)
2023,05,23,140240,82407,67974,14433,21.2,2023/05/23(20:00)
2023,05,22,140240,82998,67579,15419,22.8,2023/05/22(11:00)
2023,05,21,140240,83862,58588,25274,43.1,2023/05/21(21:00)
2023,05,20,140240,81884,60092,21792,36.3,2023/05/20(20:00)
2023,05,19,139171,82309,67914,14395,21.2,2023/05/19(20:00)
2023,05,18,139171,84042,70912,13130,18.5,2023/05/18(11:00)
2023,05,17,139171,81136,69974,11162,16,2023/05/17(20:00)
2023,05,16,139147,81823,69942,11881,17,2023/05/16(19:00)
2023,05,15,139147,82771,67563,15208,22.5,2023/05/15(20:00)
2023,05,14,139147,82371,58026,24345,42,2023/05/14(21:00)
2023,05,13,139147,82692,59028,23664,40.1,2023/05/13(21:00)
2023,05,12,139147,82904,65469,17435,26.6,2023/05/12(20:00)
2023,05,11,139147,83347,67295,16052,23.9,2023/05/11(20:00)
2023,05,10,139147,82235,66339,15896,24,2023/05/10(20:00)
2023,05,09,139065,82009,66833,15176,22.7,2023/05/09(20:00)
2023,05,08,139065,82152,65456,16696,25.5,2023/05/08(20:00)
2023,05,07,139065,82320,57038,25282,44.3,2023/05/07(21:00)
2023,05,06,139065,81015,57640,23375,40.6,2023/05/06(20:00)
2023,05,05,139065,82783,61504,21279,34.6,2023/05/05(20:00)
2023,05,04,139065,85400,66972,18428,27.5,2023/05/04(17:00)
2023,05,03,139065,84319,66914,17405,26,2023/05/03(20:00)
2023,05,02,139065,83580,66341,17239,26,2023/05/02(20:00)
2023,05,01,139065,84199,58849,25350,43.1,2023/05/01(21:00)
2023,04,30,139065,78787,56344,22443,39.8,2023/04/30(21:00)
2023,04,29,139065,80693,59105,21588,36.5,2023/04/29(12:00)
2023,04,28,139065,81098,65812,15286,23.2,2023/04/28(20:00)
2023,04,27,139065,80656,66708,13948,20.9,2023/04/27(20:00)
2023,04,26,139065,82164,66959,15205,22.7,2023/04/26(20:00)
2023,04,25,139100,82630,69358,13272,19.1,2023/04/25(17:00)
2023,04,24,139100,80652,66664,13988,21,2023/04/24(20:00)
2023,04,23,139100,81460,57975,23485,40.5,2023/04/23(21:00)
2023,04,22,139100,81689,58620,23069,39.4,2023/04/22(20:00)
2023,04,21,139100,84862,65953,18909,28.7,2023/04/21(20:00)
2023,04,20,139100,84194,69019,15175,22,2023/04/20(20:00)
2023,04,19,139100,84523,67904,16619,24.5,2023/04/19(20:00)
2023,04,18,139048,82167,71402,10765,15.1,2023/04/18(11:00)
2023,04,17,139048,82728,67016,15712,23.4,2023/04/17(20:00)
2023,04,16,139048,81738,58530,23208,39.7,2023/04/16(21:00)
2023,04,15,139048,79939,59880,20059,33.5,2023/04/15(20:00)
2023,04,14,139048,82131,67403,14728,21.9,2023/04/14(10:00)
2023,04,13,139048,82778,67686,15092,22.3,2023/04/13(20:00)
2023,04,12,139048,83551,67710,15841,23.4,2023/04/12(20:00)
2023,04,11,139079,83307,69385,13922,20.1,2023/04/11(17:00)
2023,04,10,139079,83951,67150,16801,25,2023/04/10(20:00)
2023,04,10,139079,83951,67150,16801,25,2023/04/10(20:00)
2023,04,09,139079,83956,58648,25308,43.2,2023/04/09(21:00)
2023,04,09,139079,83956,58648,25308,43.2,2023/04/09(21:00)
2023,04,08,139079,84600,59967,24633,41.1,2023/04/08(20:00)
2023,04,08,139079,84600,59967,24633,41.1,2023/04/08(20:00)
2023,04,07,139079,85615,66780,18835,28.2,2023/04/07(20:00)
2023,04,07,139079,85615,66780,18835,28.2,2023/04/07(20:00)
2023,04,06,139079,84070,70688,13382,18.9,2023/04/06(17:00)
2023,04,06,139079,84070,70688,13382,18.9,2023/04/06(17:00)
2023,04,05,139079,84179,72292,11887,16.4,2023/04/05(11:00)
2023,04,05,139079,84179,72292,11887,16.4,2023/04/05(11:00)
2023,04,04,139049,84938,68535,16403,23.9,2023/04/04(17:00)
2023,04,04,139049,84938,68535,16403,23.9,2023/04/04(17:00)
2023,04,03,139049,84289,67649,16640,24.6,2023/04/03(20:00)
2023,04,03,139049,84289,67649,16640,24.6,2023/04/03(20:00)
2023,04,02,139049,85228,58205,27023,46.4,2023/04/02(21:00)
2023,04,02,139049,85228,58205,27023,46.4,2023/04/02(21:00)
2023,04,01,139049,81707,59002,22705,38.5,2023/04/01(20:00)
2023,04,01,139049,81707,59002,22705,38.5,2023/04/01(20:00)
2023,03,31,139049,85199,65629,19570,29.8,2023/03/31(20:00)
2023,03,30,139049,86801,67833,18968,28,2023/03/30(20:00)
2023,03,29,139049,87768,68140,19628,28.8,2023/03/29(20:00)
2023,03,28,139025,86976,69012,17964,26,2023/03/28(20:00)
2023,03,27,139025,88424,69047,19377,28.1,2023/03/27(20:00)
2023,03,26,139025,83053,59275,23778,40.1,2023/03/26(20:00)
2023,03,25,139025,82416,60553,21863,36.1,2023/03/25(20:00)
2023,03,24,139025,88027,68133,19894,29.2,2023/03/24(10:00)
2023,03,23,139025,85967,71388,14579,20.4,2023/03/23(10:00)
2023,03,22,139025,85956,68792,17164,25,2023/03/22(19:00)
2023,03,21,139011,87042,68985,18057,26.2,2023/03/21(20:00)
2023,03,20,139011,83818,69333,14485,20.9,2023/03/20(20:00)
2023,03,19,139011,84692,60568,24124,39.8,2023/03/19(20:00)
2023,03,18,139011,86856,61605,25251,41,2023/03/18(20:00)
2023,03,17,139011,89299,71612,17687,24.7,2023/03/17(10:00)
2023,03,16,139011,88531,72068,16463,22.8,2023/03/16(19:00)
2023,03,15,139011,88788,70533,18255,25.9,2023/03/15(19:00)
2023,03,14,138866,89931,70755,19176,27.1,2023/03/14(19:00)
2023,03,13,138866,90608,72805,17803,24.5,2023/03/13(19:00)
2023,03,12,138866,85088,62216,22872,36.8,2023/03/12(20:00)
2023,03,11,138866,84465,60181,24284,40.4,2023/03/11(20:00)
2023,03,10,138866,91060,68901,22159,32.2,2023/03/10(09:00)
2023,03,09,138866,92036,72032,20004,27.8,2023/03/09(10:00)
2023,03,08,138866,92310,70657,21653,30.6,2023/03/08(09:00)
2023,03,07,138860,93336,72608,20728,28.5,2023/03/07(09:00)
2023,03,06,138860,92749,72424,20325,28.1,2023/03/06(09:00)
2023,03,05,138860,87307,62329,24978,40.1,2023/03/05(20:00)
2023,03,04,138860,90987,64218,26769,41.7,2023/03/04(01:00)
2023,03,03,138860,98244,75363,22881,30.4,2023/03/03(09:00)
2023,03,02,138860,97952,76510,21442,28,2023/03/02(19:00)
2023,03,01,138846,92683,69174,23509,34,2023/03/01(20:00)
2023,02,28,138846,95866,74655,21211,28.4,2023/02/28(09:00)
2023,02,27,138846,95543,74630,20913,28,2023/02/27(09:00)
2023,02,26,138846,96610,64923,31687,48.8,2023/02/26(20:00)
2023,02,25,138846,96966,66816,30150,45.1,2023/02/25(01:00)
2023,02,24,138846,98287,76151,22136,29.1,2023/02/24(09:00)
2023,02,23,138846,99004,76790,22214,28.9,2023/02/23(09:00)
2023,02,22,138846,98864,78537,20327,25.9,2023/02/22(09:00)
2023,02,21,138840,97554,79297,18257,23,2023/02/21(09:00)
2023,02,20,138840,97609,78791,18818,23.9,2023/02/20(19:00)
2023,02,19,138840,97215,65618,31597,48.2,2023/02/19(20:00)
2023,02,18,138840,94387,68387,26000,38,2023/02/18(11:00)
2023,02,17,138840,98378,79701,18677,23.4,2023/02/17(10:00)
2023,02,16,138840,99109,81126,17983,22.2,2023/02/16(10:00)
2023,02,15,138840,99470,80643,18827,23.3,2023/02/15(10:00)
2023,02,14,138817,98967,79024,19943,25.2,2023/02/14(09:00)
2023,02,13,138817,99986,81235,18751,23.1,2023/02/13(11:00)
2023,02,12,138817,98838,65888,32950,50,2023/02/12(19:00)
2023,02,11,138817,97867,67796,30071,44.4,2023/02/11(01:00)
2023,02,10,138817,99009,81340,17669,21.7,2023/02/10(10:00)
2023,02,09,138817,99329,80850,18479,22.9,2023/02/09(09:00)
2023,02,08,138817,99128,81028,18100,22.3,2023/02/08(09:00)
2023,02,07,138647,97301,81585,15716,19.3,2023/02/07(10:00)
2023,02,06,138647,100804,81935,18869,23,2023/02/06(10:00)
2023,02,05,138647,100338,67195,33143,49.3,2023/02/05(20:00)
2023,02,04,138647,100826,70005,30821,44,2023/02/04(01:00)
2023,02,03,138647,101103,84290,16813,19.9,2023/02/03(10:00)
2023,02,02,138647,101827,83228,18599,22.3,2023/02/02(09:00)
2023,02,01,138647,102478,81652,20826,25.5,2023/02/01(10:00)
2023,01,31,138643,101699,84058,17641,21,2023/01/31(09:00)
2023,01,30,138643,101644,83568,18076,21.6,2023/01/30(09:00)
2023,01,29,138643,98222,69956,28266,40.4,2023/01/29(19:00)
2023,01,28,138643,98523,74081,24442,33,2023/01/28(19:00)
2023,01,27,138643,103908,89833,14075,15.7,2023/01/27(10:00)
2023,01,26,138399,103138,92613,10525,11.4,2023/01/26(11:00)
2023,01,25,138399,103636,87275,16361,18.7,2023/01/25(18:00)
2023,01,24,138399,101038,72643,28395,39.1,2023/01/24(19:00)
2023,01,23,138399,100500,62575,37925,60.6,2023/01/23(23:00)
2023,01,22,138399,98334,60143,38191,63.5,2023/01/22(23:00)
2023,01,21,138399,99057,68910,30147,43.7,2023/01/21(01:00)
2023,01,20,138399,105249,81244,24005,29.5,2023/01/20(10:00)
2023,01,19,138399,103674,84465,19209,22.7,2023/01/19(09:00)
2023,01,18,138399,104805,85627,19178,22.4,2023/01/18(10:00)
2023,01,17,138280,107179,86815,20364,23.5,2023/01/17(10:00)
2023,01,16,138280,106545,84582,21963,26,2023/01/16(18:00)
2023,01,15,138280,103949,69166,34783,50.3,2023/01/15(19:00)
2023,01,14,138280,102803,69388,33415,48.2,2023/01/14(11:00)
2023,01,13,138280,104134,81907,22227,27.1,2023/01/13(11:00)
2023,01,12,138280,105269,82287,22982,27.9,2023/01/12(09:00)
2023,01,11,138280,103840,83078,20762,25,2023/01/11(09:00)
2023,01,10,138193,103335,83973,19362,23.1,2023/01/10(09:00)
2023,01,09,138193,102864,84683,18181,21.5,2023/01/09(10:00)
2023,01,08,138193,98882,68090,30792,45.2,2023/01/08(19:00)
2023,01,07,138193,97543,70729,26814,37.9,2023/01/07(19:00)
2023,01,06,138193,100386,86606,13780,15.9,2023/01/06(10:00)
2023,01,05,138193,103422,89012,14410,16.2,2023/01/05(10:00)
2023,01,04,138193,105387,87191,18196,20.9,2023/01/04(10:00)
2023,01,03,138018,103751,87110,16641,19.1,2023/01/03(09:00)
2023,01,02,138018,104849,85269,19580,23,2023/01/02(18:00)
2023,01,01,138018,103636,66465,37171,55.9,2023/01/01(19:00)
2022,12,31,138018,102234,68466,33768,49.3,2022/12/31(01:00)
2022,12,30,138018,104511,83307,21204,25.5,2022/12/30(10:00)
2022,12,29,138018,103136,86768,16368,18.9,2022/12/29(09:00)
2022,12,28,138018,103841,88939,14902,16.8,2022/12/28(10:00)
2022,12,27,137938,105048,89282,15766,17.7,2022/12/27(10:00)
2022,12,26,137938,103765,89935,13830,15.4,2022/12/26(10:00)
2022,12,25,137938,103170,71213,31957,44.9,2022/12/25(19:00)
2022,12,24,137938,101805,75010,26795,35.7,2022/12/24(11:00)
2022,12,23,137938,105628,94509,11119,11.8,2022/12/23(11:00)
2022,12,22,137938,104749,92999,11750,12.6,2022/12/22(17:00)
2022,12,21,137938,103274,92698,10576,11.4,2022/12/21(11:00)
2022,12,20,137875,104369,90571,13798,15.2,2022/12/20(10:00)
2022,12,19,137875,103828,91710,12118,13.2,2022/12/19(17:00)
2022,12,18,137875,101564,73852,27712,37.5,2022/12/18(19:00)
2022,12,17,137875,101175,74303,26872,36.2,2022/12/17(18:00)
2022,12,16,137875,101510,89583,11927,13.3,2022/12/16(10:00)
2022,12,15,137875,102168,88874,13294,15,2022/12/15(10:00)
2022,12,14,137875,100637,90128,10509,11.7,2022/12/14(10:00)
2022,12,13,137861,98308,85195,13113,15.4,2022/12/13(17:00)
2022,12,12,137861,97985,83311,14674,17.6,2022/12/12(17:00)
2022,12,11,137861,96222,65907,30315,46,2022/12/11(19:00)
2022,12,10,137861,93012,67446,25566,37.9,2022/12/10(18:00)
2022,12,09,137861,97136,82223,14913,18.1,2022/12/09(10:00)
2022,12,08,137861,97385,81462,15923,19.5,2022/12/08(09:00)
2022,12,07,137861,96563,82135,14428,17.6,2022/12/07(09:00)
2022,12,06,136268,97332,84058,13274,15.8,2022/12/06(10:00)
2022,12,05,136268,96977,83990,12987,15.5,2022/12/05(10:00)
2022,12,04,136268,94440,67707,26733,39.5,2022/12/04(19:00)
2022,12,03,136268,92219,67989,24230,35.6,2022/12/03(01:00)
2022,12,02,136268,94957,80829,14128,17.5,2022/12/02(09:00)
2022,12,01,136268,96487,83052,13435,16.2,2022/12/01(17:00)
2022,11,30,136268,92682,82117,10565,12.9,2022/11/30(17:00)
2022,11,29,136249,91100,75720,15380,20.3,2022/11/29(17:00)
2022,11,28,136249,87897,74855,13042,17.4,2022/11/28(17:00)
2022,11,27,136249,87912,61147,26765,43.8,2022/11/27(19:00)
2022,11,26,136249,86934,61907,25027,40.4,2022/11/26(19:00)
2022,11,25,136249,87034,70886,16148,22.8,2022/11/25(09:00)
2022,11,24,136249,85945,72420,13525,18.7,2022/11/24(09:00)
2022,11,23,136249,85867,71774,14093,19.6,2022/11/23(09:00)
2022,11,22,136207,86178,74117,12061,16.3,2022/11/22(17:00)
2022,11,21,136207,86966,71811,15155,21.1,2022/11/21(17:00)
2022,11,20,136207,85105,60057,25048,41.7,2022/11/20(19:00)
2022,11,19,136207,83590,60856,22734,37.4,2022/11/19(19:00)
2022,11,18,136207,84158,70458,13700,19.4,2022/11/18(17:00)
2022,11,17,136207,85468,71642,13826,19.3,2022/11/17(18:00)
2022,11,16,136207,86564,71687,14877,20.8,2022/11/16(17:00)
2022,11,15,136200,86049,72431,13618,18.8,2022/11/15(17:00)
2022,11,14,136200,85353,71165,14188,19.9,2022/11/14(17:00)
2022,11,13,136200,83142,60054,23088,38.4,2022/11/13(19:00)
2022,11,12,136200,81862,60675,21187,34.9,2022/11/12(19:00)
2022,11,11,136200,82359,69415,12944,18.6,2022/11/11(17:00)
2022,11,10,136200,83233,69764,13469,19.3,2022/11/10(09:00)
2022,11,09,136200,83208,69966,13242,18.9,2022/11/09(17:00)
2022,11,08,136031,84526,69806,14720,21.1,2022/11/08(18:00)
2022,11,07,136031,85170,71020,14150,19.9,2022/11/07(17:00)
2022,11,06,136031,83073,59724,23349,39.1,2022/11/06(19:00)
2022,11,05,136031,84711,61328,23383,38.1,2022/11/05(19:00)
2022,11,04,136031,84682,70733,13949,19.7,2022/11/04(18:00)
2022,11,03,136031,84448,71242,13206,18.5,2022/11/03(17:00)
2022,11,02,136031,84799,69282,15517,22.4,2022/11/02(18:00)
2022,11,01,136031,82712,69729,12983,18.6,2022/11/01(19:00)
2022,10,31,136031,86565,69769,16796,24.1,2022/10/31(19:00)
2022,10,30,134823,83152,58605,24547,41.9,2022/10/30(19:00)
2022,10,29,134823,82677,59900,22777,38,2022/10/29(19:00)
2022,10,28,134823,84939,68956,15983,23.2,2022/10/28(18:00)
2022,10,27,134823,85104,70573,14531,20.6,2022/10/27(19:00)
2022,10,26,134823,84774,70052,14722,21,2022/10/26(19:00)
2022,10,25,134823,85434,70495,14939,21.2,2022/10/25(19:00)
2022,10,24,134823,83828,70139,13689,19.5,2022/10/24(19:00)
2022,10,23,134823,82226,58500,23726,40.6,2022/10/23(19:00)
2022,10,22,134823,80425,60433,19992,33.1,2022/10/22(19:00)
2022,10,21,134823,83851,69240,14611,21.1,2022/10/21(19:00)
2022,10,20,134823,84256,70976,13280,18.7,2022/10/20(19:00)
2022,10,19,134823,85998,70250,15748,22.4,2022/10/19(19:00)
2022,10,18,134824,86919,70701,16218,22.9,2022/10/18(19:00)
2022,10,17,134824,86767,70021,16746,23.9,2022/10/17(19:00)
2022,10,16,134824,84594,59248,25346,42.8,2022/10/16(19:00)
2022,10,15,134824,82961,60625,22336,36.8,2022/10/15(19:00)
2022,10,14,134824,82757,69004,13753,19.9,2022/10/14(19:00)
2022,10,13,134824,83262,70316,12946,18.4,2022/10/13(19:00)
2022,10,12,134797,83927,69872,14055,20.1,2022/10/12(19:00)
2022,10,11,134797,84595,70344,14251,20.3,2022/10/11(19:00)
2022,10,10,134797,84696,62700,21996,35.1,2022/10/10(20:00)
2022,10,09,134797,86454,58315,28139,48.3,2022/10/09(19:00)
2022,10,08,134797,85508,59871,25637,42.8,2022/10/08(19:00)
2022,10,07,134797,87225,68983,18242,26.4,2022/10/07(19:00)
2022,10,06,134797,86440,70544,15896,22.5,2022/10/06(19:00)
2022,10,05,134768,85928,70074,15854,22.6,2022/10/05(19:00)
2022,10,04,134768,86098,72544,13554,18.7,2022/10/04(10:00)
2022,10,03,134768,86928,66998,19930,29.7,2022/10/03(19:00)
2022,10,02,134768,84572,59834,24738,41.3,2022/10/02(19:00)
2022,10,01,134768,83632,61848,21784,35.2,2022/10/01(19:00)
2022,09,30,134768,88547,71844,16703,23.2,2022/09/30(18:00)
2022,09,29,134768,87139,73018,14121,19.3,2022/09/29(18:00)
2022,09,28,134725,88782,72806,15976,21.9,2022/09/28(17:00)
2022,09,27,134725,88928,72742,16186,22.3,2022/09/27(19:00)
2022,09,26,134725,89385,71400,17985,25.2,2022/09/26(17:00)
2022,09,25,134725,87931,59920,28011,46.7,2022/09/25(20:00)
2022,09,24,134725,87890,61033,26857,44,2022/09/24(20:00)
2022,09,23,134725,89172,70071,19101,27.3,2022/09/23(17:00)
2022,09,22,134725,87478,72184,15294,21.2,2022/09/22(19:00)
2022,09,21,134725,87357,72071,15286,21.2,2022/09/21(18:00)
2022,09,20,134719,88671,73548,15123,20.6,2022/09/20(17:00)
2022,09,19,134719,92433,78589,13844,17.6,2022/09/19(17:00)
2022,09,18,134719,89824,70720,19104,27,2022/09/18(20:00)
2022,09,17,134719,87077,71108,15969,22.5,2022/09/17(20:00)
2022,09,16,134719,91923,82122,9801,11.9,2022/09/16(17:00)
2022,09,15,134719,91430,79407,12023,15.1,2022/09/15(17:00)
2022,09,14,134702,93018,76406,16612,21.7,2022/09/14(17:00)
2022,09,13,134702,92082,75687,16395,21.7,2022/09/13(17:00)
2022,09,12,134702,91334,61790,29544,47.8,2022/09/12(20:00)
2022,09,11,134702,91779,57250,34529,60.3,2022/09/11(20:00)
2022,09,10,134702,93326,53936,39390,73,2022/09/10(20:00)
2022,09,09,134702,94422,57303,37119,64.8,2022/09/09(20:00)
2022,09,08,134702,95199,67681,27518,40.7,2022/09/08(20:00)
2022,09,07,134702,98348,73807,24541,33.3,2022/09/07(18:00)
2022,09,06,134695,97699,73602,24097,32.7,2022/09/06(18:00)
2022,09,05,134695,97945,79872,18073,22.6,2022/09/05(15:00)
2022,09,04,134695,97062,67901,29161,42.9,2022/09/04(20:00)
2022,09,03,134695,95712,67164,28548,42.5,2022/09/03(20:00)
2022,09,02,134695,99473,77142,22331,28.9,2022/09/02(17:00)
2022,09,01,134695,98608,78089,20519,26.3,2022/09/01(17:00)
2022,08,31,134695,99257,74990,24267,32.4,2022/08/31(11:00)
2022,08,30,134509,99404,77097,22307,28.9,2022/08/30(15:00)
2022,08,29,134509,98962,75328,23634,31.4,2022/08/29(15:00)
2022,08,28,134509,96902,64155,32747,51,2022/08/28(20:00)
2022,08,27,134509,97877,64721,33156,51.2,2022/08/27(20:00)
2022,08,26,134509,102136,77935,24201,31.1,2022/08/26(17:00)
2022,08,25,134509,102008,79448,22560,28.4,2022/08/25(17:00)
2022,08,24,134509,101820,79100,22720,28.7,2022/08/24(11:00)
2022,08,23,134462,101268,86792,14476,16.7,2022/08/23(15:00)
2022,08,22,134462,102558,86842,15716,18.1,2022/08/22(17:00)
2022,08,21,134462,96045,73895,22150,30,2022/08/21(20:00)
2022,08,20,134462,95284,76241,19043,25,2022/08/20(20:00)
2022,08,19,134462,100632,86684,13948,16.1,2022/08/19(17:00)
2022,08,18,134462,101828,83585,18243,21.8,2022/08/18(18:00)
2022,08,17,134446,101195,84518,16677,19.7,2022/08/17(18:00)
2022,08,16,134446,101402,86440,14962,17.3,2022/08/16(17:00)
2022,08,15,134446,99379,80123,19256,24,2022/08/15(20:00)
2022,08,14,134446,95386,74228,21158,28.5,2022/08/14(20:00)
2022,08,13,134446,95281,73971,21310,28.8,2022/08/13(20:00)
2022,08,12,134446,100802,85622,15180,17.7,2022/08/12(18:00)
2022,08,11,134446,100101,85488,14613,17.1,2022/08/11(11:00)
2022,08,10,134446,100922,85666,15256,17.8,2022/08/10(15:00)
2022,08,09,134417,100864,88479,12385,14,2022/08/09(18:00)
2022,08,08,134417,100691,89263,11428,12.8,2022/08/08(17:00)
2022,08,07,134417,100210,78998,21212,26.9,2022/08/07(20:00)
2022,08,06,134417,100321,80391,19930,24.8,2022/08/06(20:00)
2022,08,05,134417,102311,86550,15761,18.2,2022/08/05(18:00)
2022,08,04,134417,101790,85866,15924,18.5,2022/08/04(18:00)
2022,08,03,134417,100831,81174,19657,24.2,2022/08/03(18:00)
2022,08,02,134291,99741,77981,21760,27.9,2022/08/02(20:00)
2022,08,01,134291,99761,80055,19706,24.6,2022/08/01(18:00)
2022,07,31,134291,97211,72224,24987,34.6,2022/07/31(20:00)
2022,07,30,134291,96642,76651,19991,26.1,2022/07/30(20:00)
2022,07,29,134291,101383,87601,13782,15.7,2022/07/29(17:00)
2022,07,28,134291,100467,87405,13062,14.9,2022/07/28(18:00)
2022,07,27,134291,100687,85507,15180,17.8,2022/07/27(18:00)
2022,07,26,134269,100295,87347,12948,14.8,2022/07/26(18:00)
2022,07,25,134269,99610,84338,15272,18.1,2022/07/25(18:00)
2022,07,24,134269,96305,69817,26488,37.9,2022/07/24(20:00)
2022,07,23,134269,96461,70266,26195,37.3,2022/07/23(20:00)
2022,07,22,134269,100057,80509,19548,24.3,2022/07/22(17:00)
2022,07,21,134269,99835,82156,17679,21.5,2022/07/21(15:00)
2022,07,20,134269,99728,85756,13972,16.3,2022/07/20(18:00)
2022,07,19,134266,99472,84631,14841,17.5,2022/07/19(18:00)
2022,07,18,134266,97680,83578,14102,16.9,2022/07/18(15:00)
2022,07,17,134266,96711,70356,26355,37.5,2022/07/17(21:00)
2022,07,16,134266,96946,71327,25619,35.9,2022/07/16(20:00)
2022,07,15,134266,100653,83272,17381,20.9,2022/07/15(17:00)
2022,07,14,134266,100515,85530,14985,17.5,2022/07/14(18:00)
2022,07,13,134266,100299,85034,15265,18,2022/07/13(15:00)
2022,07,12,134239,99071,87250,11821,13.5,2022/07/12(17:00)
2022,07,11,134239,100015,86943,13072,15,2022/07/11(17:00)
2022,07,10,134239,96494,75168,21326,28.4,2022/07/10(20:00)
2022,07,09,134239,96076,75216,20860,27.7,2022/07/09(20:00)
2022,07,08,134239,99997,86475,13522,15.6,2022/07/08(17:00)
2022,07,07,134239,99716,92990,6726,7.2,2022/07/07(17:00)
2022,07,06,134239,99959,91938,8021,8.7,2022/07/06(18:00)
2022,07,05,134237,99463,90855,8608,9.5,2022/07/05(17:00)
2022,07,04,134237,99188,89337,9851,11,2022/07/04(17:00)
2022,07,03,134237,87495,74464,13031,17.5,2022/07/03(20:00)
2022,07,02,134237,88500,74974,13526,18,2022/07/02(20:00)
2022,07,01,134237,93231,83309,9922,11.9,2022/07/01(18:00)
2022,06,30,134237,93599,82731,10868,13.1,2022/06/30(17:00)
2022,06,29,134237,95432,84492,10940,12.9,2022/06/29(17:00)
2022,06,28,134092,93797,84057,9740,11.6,2022/06/28(17:00)
2022,06,27,134092,94364,84739,9625,11.4,2022/06/27(17:00)
2022,06,26,134092,86439,68906,17533,25.4,2022/06/26(21:00)
2022,06,25,134092,84436,69554,14882,21.4,2022/06/25(20:00)
2022,06,24,134092,92119,76118,16001,21,2022/06/24(17:00)
2022,06,23,134092,91404,83449,7955,9.5,2022/06/23(15:00)
2022,06,22,134092,91108,80941,10167,12.6,2022/06/22(17:00)
2022,06,21,134066,91094,81164,9930,12.2,2022/06/21(17:00)
2022,06,20,134066,87774,77816,9958,12.8,2022/06/20(18:00)
2022,06,19,134066,85859,64404,21455,33.3,2022/06/19(21:00)
2022,06,18,134066,85104,64277,20827,32.4,2022/06/18(20:00)
2022,06,17,134066,87896,73461,14435,19.6,2022/06/17(17:00)
2022,06,16,134066,85906,70925,14981,21.1,2022/06/16(19:00)
2022,06,15,134066,85748,69275,16473,23.8,2022/06/15(18:00)
2022,06,14,134060,86350,71477,14873,20.8,2022/06/14(17:00)
2022,06,13,134060,87376,71248,16128,22.6,2022/06/13(18:00)
2022,06,12,134060,82389,61303,21086,34.4,2022/06/12(21:00)
2022,06,11,134060,81919,62034,19885,32.1,2022/06/11(21:00)
2022,06,10,134060,85397,71317,14080,19.7,2022/06/10(17:00)
2022,06,09,134060,86254,69993,16261,23.2,2022/06/09(18:00)
2022,06,08,134060,85703,68480,17223,25.2,2022/06/08(20:00)
2022,06,07,134186,85109,70522,14587,20.7,2022/06/07(17:00)
2022,06,06,134186,83093,61814,21279,34.4,2022/06/06(21:00)
2022,06,05,134186,80301,58600,21701,37,2022/06/05(20:00)
2022,06,04,134186,82590,62408,20182,32.3,2022/06/04(21:00)
2022,06,03,134186,84094,72128,11966,16.6,2022/06/03(17:00)
2022,06,02,134186,83606,71717,11889,16.6,2022/06/02(18:00)
2022,06,01,134186,79189,64790,14399,22.2,2022/06/01(20:00)
2022,05,31,133917,84553,69888,14665,21,2022/05/31(18:00)
2022,05,30,133917,84474,73134,11340,15.5,2022/05/30(17:00)
2022,05,29,133917,79357,60948,18409,30.2,2022/05/29(21:00)
2022,05,28,133917,76955,61733,15222,24.7,2022/05/28(21:00)
2022,05,27,133917,82016,68961,13055,18.9,2022/05/27(19:00)
2022,05,26,133917,82378,69479,12899,18.6,2022/05/26(19:00)
2022,05,25,133917,82910,72539,10371,14.3,2022/05/25(17:00)
2022,05,24,133917,81847,72576,9271,12.8,2022/05/24(18:00)
2022,05,23,133917,81075,72122,8953,12.4,2022/05/23(17:00)
2022,05,22,133917,77792,60230,17562,29.2,2022/05/22(21:00)
2022,05,21,133917,73392,60962,12430,20.4,2022/05/21(21:00)
2022,05,20,133917,78019,68019,10000,14.7,2022/05/20(20:00)
2022,05,19,133917,78739,68981,9758,14.1,2022/05/19(20:00)
2022,05,18,133917,80022,69000,11022,16,2022/05/18(19:00)
2022,05,17,133917,78740,69598,9142,13.1,2022/05/17(20:00)
2022,05,16,133917,81117,68158,12959,19,2022/05/16(20:00)
2022,05,15,133917,80194,58322,21872,37.5,2022/05/15(21:00)
2022,05,14,133917,77018,59523,17495,29.4,2022/05/14(21:00)
2022,05,13,133917,81648,70215,11433,16.3,2022/05/13(15:00)
2022,05,12,133917,78815,69519,9296,13.4,2022/05/12(20:00)
2022,05,11,133917,82127,69284,12843,18.5,2022/05/11(18:00)
2022,05,10,133917,81916,68449,13467,19.7,2022/05/10(20:00)
2022,05,09,133917,82664,68295,14369,21,2022/05/09(20:00)
2022,05,08,133917,78693,57573,21120,36.7,2022/05/08(21:00)
2022,05,07,133917,74588,58240,16348,28.1,2022/05/07(21:00)
2022,05,06,133917,83815,65275,18540,28.4,2022/05/06(20:00)
2022,05,05,133917,82440,62398,20042,32.1,2022/05/05(21:00)
2022,05,04,133917,84671,66896,17775,26.6,2022/05/04(20:00)
2022,05,03,133680,85122,68221,16901,24.8,2022/05/03(20:00)
2022,05,02,133680,84804,67357,17447,25.9,2022/05/02(20:00)
2022,05,01,133680,80599,57624,22975,39.9,2022/05/01(21:00)
2022,04,30,133680,81336,58925,22411,38,2022/04/30(21:00)
2022,04,29,133680,83895,67684,16211,24,2022/04/29(09:00)
2022,04,28,133680,82861,68086,14775,21.7,2022/04/28(20:00)
2022,04,27,133680,83673,67404,16269,24.1,2022/04/27(20:00)
2022,04,26,133680,81625,69997,11628,16.6,2022/04/26(17:00)
2022,04,25,133680,82516,69646,12870,18.5,2022/04/25(17:00)
2022,04,24,133680,77599,58501,19098,32.6,2022/04/24(20:00)
2022,04,23,133680,77509,58909,18600,31.6,2022/04/23(20:00)
2022,04,22,133680,82377,67015,15362,22.9,2022/04/22(20:00)
2022,04,21,133680,82006,68547,13459,19.6,2022/04/21(20:00)
2022,04,20,133680,82087,67702,14385,21.2,2022/04/20(20:00)
2022,04,19,133680,82152,68498,13654,19.9,2022/04/19(20:00)
2022,04,18,133680,80747,67906,12841,18.9,2022/04/18(20:00)
2022,04,17,133680,77578,58749,18829,32,2022/04/17(21:00)
2022,04,16,133680,77102,59944,17158,28.6,2022/04/16(20:00)
2022,04,15,133680,83940,67132,16808,25,2022/04/15(20:00)
2022,04,14,133680,84050,71334,12716,17.8,2022/04/14(10:00)
2022,04,13,133680,84457,71879,12578,17.5,2022/04/13(17:00)
2022,04,12,133680,84159,69958,14201,20.3,2022/04/12(19:00)
2022,04,11,133680,83037,68821,14216,20.7,2022/04/11(20:00)
2022,04,10,133680,79188,58490,20698,35.4,2022/04/10(20:00)
2022,04,09,133680,78558,60137,18421,30.6,2022/04/09(20:00)
2022,04,08,133680,84389,67293,17096,25.4,2022/04/08(20:00)
2022,04,07,133561,84039,69860,14179,20.3,2022/04/07(20:00)
2022,04,06,133561,83820,69222,14598,21.1,2022/04/06(20:00)
2022,04,05,133561,84085,70446,13639,19.4,2022/04/05(20:00)
2022,04,04,133561,84320,69891,14429,20.6,2022/04/04(20:00)
2022,04,03,133561,81121,60331,20790,34.5,2022/04/03(21:00)
2022,04,02,133561,81417,61732,19685,31.9,2022/04/02(20:00)
2022,04,01,133561,86929,68838,18091,26.3,2022/04/01(20:00)
2022,03,31,133561,83397,70618,12779,18.1,2022/03/31(20:00)
2022,03,30,133561,83144,71112,12032,16.9,2022/03/30(17:00)
2022,03,29,133561,83223,70311,12912,18.4,2022/03/29(20:00)
2022,03,28,133561,83826,70765,13061,18.5,2022/03/28(20:00)
2022,03,27,133561,81196,60623,20573,33.9,2022/03/27(20:00)
2022,03,26,133561,78264,62291,15973,25.6,2022/03/26(10:00)
2022,03,25,133561,84019,71135,12884,18.1,2022/03/25(09:00)
2022,03,24,133561,83716,73156,10560,14.4,2022/03/24(09:00)
2022,03,23,133561,89033,78233,10800,13.8,2022/03/23(10:00)
2022,03,22,133561,86161,73197,12964,17.7,2022/03/22(20:00)
2022,03,21,133561,86078,74381,11697,15.7,2022/03/21(17:00)
2022,03,20,133561,83653,62882,20771,33,2022/03/20(20:00)
2022,03,19,133561,84686,66838,17848,26.7,2022/03/19(11:00)
2022,03,18,133561,89903,76980,12923,16.8,2022/03/18(10:00)
2022,03,17,133561,87346,75585,11761,15.6,2022/03/17(10:00)
2022,03,16,133561,87501,70966,16535,23.3,2022/03/16(09:00)
2022,03,15,133561,92568,71988,20580,28.6,2022/03/15(19:00)
2022,03,14,133561,91813,76789,15024,19.6,2022/03/14(15:00)
2022,03,13,133561,83055,61436,21619,35.2,2022/03/13(20:00)
2022,03,12,133561,83382,62114,21268,34.2,2022/03/12(20:00)
2022,03,11,133561,91552,74509,17043,22.9,2022/03/11(10:00)
2022,03,10,133561,93595,73841,19754,26.8,2022/03/10(09:00)
2022,03,09,133561,92928,67781,25147,37.1,2022/03/09(20:00)
2022,03,08,133561,90369,76762,13607,17.7,2022/03/08(09:00)
2022,03,07,133069,88990,77345,11645,15.1,2022/03/07(10:00)
2022,03,06,133069,81233,64675,16558,25.6,2022/03/06(20:00)
2022,03,05,133069,82102,66375,15727,23.7,2022/03/05(20:00)
2022,03,04,133069,89526,78189,11337,14.5,2022/03/04(09:00)
2022,03,03,133069,91888,77182,14706,19.1,2022/03/03(09:00)
2022,03,02,133069,93798,77502,16296,21,2022/03/02(09:00)
2022,03,01,133069,92392,69920,22472,32.1,2022/03/01(20:00)
2022,02,28,133069,91911,73959,17952,24.3,2022/02/28(09:00)
2022,02,27,133069,95229,64965,30264,46.6,2022/02/27(20:00)
2022,02,26,133069,97176,67374,29802,44.2,2022/02/26(01:00)
2022,02,25,133069,98432,80824,17608,21.8,2022/02/25(09:00)
2022,02,24,133069,97557,83453,14104,16.9,2022/02/24(09:00)
2022,02,23,133069,98038,85489,12549,14.7,2022/02/23(10:00)
2022,02,22,133069,96702,83248,13454,16.2,2022/02/22(19:00)
2022,02,21,133069,97347,82900,14447,17.4,2022/02/21(17:00)
2022,02,20,133069,96907,69627,27280,39.2,2022/02/20(20:00)
2022,02,19,133069,98848,70632,28216,39.9,2022/02/19(11:00)
2022,02,18,133069,100716,84164,16552,19.7,2022/02/18(09:00)
2022,02,17,133069,103184,86434,16750,19.4,2022/02/17(10:00)
2022,02,16,133069,103942,86687,17255,19.9,2022/02/16(10:00)
2022,02,15,133069,104682,83893,20789,24.8,2022/02/15(10:00)
2022,02,14,133069,103073,79225,23848,30.1,2022/02/14(10:00)
2022,02,13,133069,100238,65396,34842,53.3,2022/02/13(20:00)
2022,02,12,133069,100573,67542,33031,48.9,2022/02/12(09:00)
2022,02,11,133069,102618,81928,20690,25.3,2022/02/11(09:00)
2022,02,10,133069,103674,81626,22048,27,2022/02/10(09:00)
2022,02,09,133069,101527,83819,17708,21.1,2022/02/09(09:00)
2022,02,08,133069,102163,85352,16811,19.7,2022/02/08(10:00)
2022,02,07,133069,100103,87351,12752,14.6,2022/02/07(17:00)
2022,02,06,133069,100922,69718,31204,44.8,2022/02/06(19:00)
2022,02,05,133069,100908,73089,27819,38.1,2022/02/05(19:00)
2022,02,04,133069,102340,82614,19726,23.9,2022/02/04(17:00)
2022,02,03,133069,102205,78841,23364,29.6,2022/02/03(18:00)
2022,02,02,133069,99458,63795,35663,55.9,2022/02/02(19:00)
2022,02,01,133069,97064,59840,37224,62.2,2022/02/01(23:00)
2022,01,31,134123,95850,61339,34511,56.3,2022/01/31(01:00)
2022,01,30,134123,95905,65026,30879,47.5,2022/01/30(19:00)
2022,01,29,134123,98753,68009,30744,45.2,2022/01/29(19:00)
2022,01,28,134123,104633,82283,22350,27.2,2022/01/28(09:00)
2022,01,27,134123,103391,82938,20453,24.7,2022/01/27(09:00)
2022,01,26,134123,103430,82984,20446,24.6,2022/01/26(10:00)
2022,01,25,134123,102737,86241,16496,19.1,2022/01/25(11:00)
2022,01,24,134020,103205,83085,20120,24.2,2022/01/24(10:00)
2022,01,23,134020,100014,67726,32288,47.7,2022/01/23(19:00)
2022,01,22,134020,99165,72105,27060,37.5,2022/01/22(09:00)
2022,01,21,134020,104526,86522,18004,20.8,2022/01/21(09:00)
2022,01,20,134020,105164,87884,17280,19.7,2022/01/20(10:00)
2022,01,19,134020,104860,88076,16784,19.1,2022/01/19(17:00)
2022,01,18,134020,104684,87579,17105,19.5,2022/01/18(09:00)
2022,01,17,134020,104610,87967,16643,18.9,2022/01/17(17:00)
2022,01,16,134020,99043,70090,28953,41.3,2022/01/16(19:00)
2022,01,15,134020,99046,71585,27461,38.4,2022/01/15(09:00)
2022,01,14,134020,106463,87278,19185,22,2022/01/14(09:00)
2022,01,13,134020,107327,89115,18212,20.4,2022/01/13(17:00)
2022,01,12,134020,107063,88305,18758,21.2,2022/01/12(10:00)
2022,01,11,134020,107504,88103,19401,22,2022/01/11(17:00)
2022,01,10,134020,104076,85301,18775,22,2022/01/10(10:00)
2022,01,09,134020,101437,67889,33548,49.4,2022/01/09(19:00)
2022,01,08,134020,102853,70793,32060,45.3,2022/01/08(09:00)
2022,01,07,134020,107169,85425,21744,25.5,2022/01/07(09:00)
2022,01,06,134020,107486,84761,22725,26.8,2022/01/06(09:00)
2022,01,05,134020,107631,89397,18234,20.4,2022/01/05(10:00)
2022,01,04,134020,106705,85161,21544,25.3,2022/01/04(09:00)
2022,01,03,134020,107391,85196,22195,26.1,2022/01/03(17:00)
2022,01,02,134020,103896,68173,35723,52.4,2022/01/02(19:00)
2022,01,01,134020,101222,67369,33853,50.3,2022/01/01(01:00)
2021,12,31,134158,105752,81748,24004,29.4,2021/12/31(09:00)
2021,12,30,134158,105343,84564,20779,24.6,2021/12/30(17:00)
2021,12,29,134158,103867,85966,17901,20.8,2021/12/29(10:00)
2021,12,28,134158,101789,88717,13072,14.7,2021/12/28(10:00)
2021,12,27,134158,103554,90708,12846,14.2,2021/12/27(17:00)
2021,12,26,134158,101244,71719,29525,41.2,2021/12/26(19:00)
2021,12,25,134158,101662,72815,28847,39.6,2021/12/25(19:00)
2021,12,24,134012,101856,81185,20671,25.5,2021/12/24(10:00)
2021,12,23,134012,102837,81874,20963,25.6,2021/12/23(09:00)
2021,12,22,134012,101750,81451,20299,24.9,2021/12/22(09:00)
2021,12,21,134012,101328,80294,21034,26.2,2021/12/21(09:00)
2021,12,20,133896,102725,81750,20971,25.7,2021/12/20(10:00)
2021,12,19,133896,99975,67544,32431,48,2021/12/19(19:00)
2021,12,18,133896,98106,70883,27223,38.4,2021/12/18(09:00)
2021,12,17,133896,104301,85699,18602,21.7,2021/12/17(17:00)
2021,12,16,133896,99929,81399,18530,22.8,2021/12/16(10:00)
2021,12,15,133896,100450,79839,20611,25.8,2021/12/15(10:00)
2021,12,14,133896,101254,82571,18683,22.6,2021/12/14(10:00)
2021,12,13,133896,102797,82173,20624,25.1,2021/12/13(17:00)
2021,12,12,133896,98173,65441,32732,50,2021/12/12(19:00)
2021,12,11,133896,94870,64834,30036,46.3,2021/12/11(19:00)
2021,12,10,133896,100525,77936,22589,29,2021/12/10(10:00)
2021,12,09,133896,100769,78182,22587,28.9,2021/12/09(17:00)
2021,12,08,133896,100449,78310,22139,28.3,2021/12/08(09:00)
2021,12,07,133896,100638,78079,22559,28.9,2021/12/07(09:00)
2021,12,06,133896,100061,78083,21978,28.1,2021/12/06(17:00)
2021,12,05,133896,93599,64032,29567,46.2,2021/12/05(19:00)
2021,12,04,133896,94435,65770,28665,43.6,2021/12/04(19:00)
2021,12,03,133896,96839,78696,18143,23.1,2021/12/03(17:00)
2021,12,02,133896,95116,80145,14971,18.7,2021/12/02(17:00)
2021,12,01,133564,96460,81177,15283,18.8,2021/12/01(17:00)
2021,11,30,133564,95394,80362,15032,18.7,2021/11/30(11:00)
2021,11,29,133564,94302,75340,18962,25.2,2021/11/29(17:00)
2021,11,28,133564,91146,62027,29119,46.9,2021/11/28(19:00)
2021,11,27,133564,92026,63937,28089,43.9,2021/11/27(19:00)
2021,11,26,133564,96502,75223,21279,28.3,2021/11/26(17:00)
2021,11,25,133564,95904,74510,21394,28.7,2021/11/25(18:00)
2021,11,24,133564,93131,76210,16921,22.2,2021/11/24(10:00)
2021,11,23,133564,91056,79838,11218,14.1,2021/11/23(17:00)
2021,11,22,133564,88726,76847,11879,15.5,2021/11/22(17:00)
2021,11,21,133564,80551,60516,20035,33.1,2021/11/21(19:00)
2021,11,20,133564,82811,61390,21421,34.9,2021/11/20(19:00)
2021,11,19,133564,85565,70926,14639,20.6,2021/11/19(09:00)
2021,11,18,133564,84890,72485,12405,17.1,2021/11/18(17:00)
2021,11,17,133564,85564,73028,12536,17.2,2021/11/17(17:00)
2021,11,16,133564,84252,72310,11942,16.5,2021/11/16(18:00)
2021,11,15,133564,84114,71603,12511,17.5,2021/11/15(17:00)
2021,11,14,133564,80771,59863,20908,34.9,2021/11/14(19:00)
2021,11,13,133564,82198,61840,20358,32.9,2021/11/13(01:00)
2021,11,12,133564,85381,73855,11526,15.6,2021/11/12(17:00)
2021,11,11,133564,85839,74708,11131,14.9,2021/11/11(17:00)
2021,11,10,133455,84601,73477,11124,15.1,2021/11/10(17:00)
2021,11,09,133455,84443,72800,11643,16,2021/11/09(17:00)
2021,11,08,133455,86547,72602,13945,19.2,2021/11/08(11:00)
2021,11,07,133455,80184,58370,21814,37.4,2021/11/07(19:00)
2021,11,06,133455,78785,59456,19329,32.5,2021/11/06(19:00)
2021,11,05,133455,84602,68742,15860,23.1,2021/11/05(17:00)
2021,11,04,133455,84334,70149,14185,20.2,2021/11/04(17:00)
2021,11,03,133455,83854,69599,14255,20.5,2021/11/03(17:00)
2021,11,02,133455,85478,69554,15924,22.9,2021/11/02(19:00)
2021,11,01,133455,85827,69259,16568,23.9,2021/11/01(17:00)
2021,10,31,133455,83019,58161,24858,42.7,2021/10/31(19:00)
2021,10,30,133455,82627,59770,22857,38.2,2021/10/30(19:00)
2021,10,29,132113,84869,67683,17186,25.4,2021/10/29(18:00)
2021,10,28,132113,82479,69488,12991,18.7,2021/10/28(19:00)
2021,10,27,132113,83310,68937,14373,20.8,2021/10/27(18:00)
2021,10,26,132113,83798,69601,14197,20.4,2021/10/26(19:00)
2021,10,25,132113,83115,69114,14001,20.3,2021/10/25(19:00)
2021,10,24,132113,80298,57699,22599,39.2,2021/10/24(19:00)
2021,10,23,132113,81426,59042,22384,37.9,2021/10/23(19:00)
2021,10,22,132113,85343,67900,17443,25.7,2021/10/22(19:00)
2021,10,21,132113,81902,70203,11699,16.7,2021/10/21(19:00)
2021,10,20,132113,80245,69414,10831,15.6,2021/10/20(19:00)
2021,10,19,132113,81211,69823,11388,16.3,2021/10/19(19:00)
2021,10,18,132113,81221,69348,11873,17.1,2021/10/18(19:00)
2021,10,17,132113,79452,58640,20812,35.5,2021/10/17(20:00)
2021,10,16,132113,79999,60050,19949,33.2,2021/10/16(19:00)
2021,10,15,132113,78551,70778,7773,11,2021/10/15(17:00)
2021,10,14,132113,80638,71458,9180,12.8,2021/10/14(19:00)
2021,10,13,132113,81390,70657,10733,15.2,2021/10/13(19:00)
2021,10,12,132113,83052,70121,12931,18.4,2021/10/12(17:00)
2021,10,11,132113,81058,64647,16411,25.4,2021/10/11(19:00)
2021,10,10,132113,80249,61162,19087,31.2,2021/10/10(19:00)
2021,10,09,132113,79238,63659,15579,24.5,2021/10/09(19:00)
2021,10,08,132113,83473,72717,10756,14.8,2021/10/08(17:00)
2021,10,07,132113,82862,73754,9108,12.3,2021/10/07(17:00)
2021,10,06,132113,83917,73845,10072,13.6,2021/10/06(17:00)
2021,10,05,131895,82449,75698,6751,8.9,2021/10/05(18:00)
2021,10,04,131895,78098,69932,8166,11.7,2021/10/04(19:00)
2021,10,03,131895,74037,60876,13161,21.6,2021/10/03(19:00)
2021,10,02,131895,74989,62298,12691,20.4,2021/10/02(19:00)
2021,10,01,131895,83684,72146,11538,16,2021/10/01(17:00)
2021,09,30,131895,83670,73226,10444,14.3,2021/09/30(18:00)
2021,09,29,131895,84542,75683,8859,11.7,2021/09/29(16:00)
2021,09,28,131895,82881,74094,8787,11.9,2021/09/28(17:00)
2021,09,27,131895,82653,72396,10257,14.2,2021/09/27(17:00)
2021,09,26,131895,81338,60737,20601,33.9,2021/09/26(20:00)
2021,09,25,131895,80070,61851,18219,29.5,2021/09/25(20:00)
2021,09,24,131895,81455,68879,12576,18.3,2021/09/24(17:00)
2021,09,23,131895,82499,67149,15350,22.9,2021/09/23(19:00)
2021,09,22,131895,85961,57177,28784,50.3,2021/09/22(20:00)
2021,09,21,131895,85539,53652,31887,59.4,2021/09/21(20:00)
2021,09,20,131895,84913,55779,29134,52.2,2021/09/20(20:00)
2021,09,19,131895,84130,58954,25176,42.7,2021/09/19(20:00)
2021,09,18,131895,84328,62245,22083,35.5,2021/09/18(20:00)
2021,09,17,131895,88469,71837,16632,23.2,2021/09/17(11:00)
2021,09,16,131895,88754,75436,13318,17.7,2021/09/16(17:00)
2021,09,15,131895,90836,74944,15892,21.2,2021/09/15(17:00)
2021,09,14,131895,90371,76081,14290,18.8,2021/09/14(18:00)
2021,09,13,131895,90532,77820,12712,16.3,2021/09/13(17:00)
2021,09,12,131895,90272,64512,25760,39.9,2021/09/12(20:00)
2021,09,11,131895,88890,65783,23107,35.1,2021/09/11(20:00)
2021,09,10,131895,94120,75304,18816,25,2021/09/10(17:00)
2021,09,09,131895,95161,76594,18567,24.2,2021/09/09(17:00)
2021,09,08,131650,95992,74423,21569,29,2021/09/08(17:00)
2021,09,07,131650,93587,76075,17512,23,2021/09/07(17:00)
2021,09,06,131650,95624,75426,20198,26.8,2021/09/06(17:00)
2021,09,05,131650,91917,62545,29372,47,2021/09/05(20:00)
2021,09,04,131650,92603,63885,28718,45,2021/09/04(20:00)
2021,09,03,131650,99017,74073,24944,33.7,2021/09/03(17:00)
2021,09,02,131650,98606,76036,22570,29.7,2021/09/02(17:00)
2021,09,01,131650,98658,77228,21430,27.7,2021/09/01(17:00)
2021,08,31,131650,100757,77665,23092,29.7,2021/08/31(17:00)
2021,08,30,131650,99798,78996,20802,26.3,2021/08/30(17:00)
2021,08,29,131650,95099,65588,29511,45,2021/08/29(20:00)
2021,08,28,131650,94472,66357,28115,42.4,2021/08/28(20:00)
2021,08,27,131650,99432,78339,21093,26.9,2021/08/27(15:00)
2021,08,26,131650,99284,81471,17813,21.9,2021/08/26(17:00)
2021,08,25,131650,97998,80262,17736,22.1,2021/08/25(11:00)
2021,08,24,131650,99256,81241,18015,22.2,2021/08/24(17:00)
2021,08,23,131330,98884,79334,19550,24.6,2021/08/23(15:00)
2021,08,22,131330,94493,66387,28106,42.3,2021/08/22(20:00)
2021,08,21,131330,95487,69215,26272,38,2021/08/21(12:00)
2021,08,20,131330,100721,79554,21167,26.6,2021/08/20(18:00)
2021,08,19,131330,99622,79472,20150,25.4,2021/08/19(18:00)
2021,08,18,131330,99241,80362,18879,23.5,2021/08/18(17:00)
2021,08,17,131330,100178,80393,19785,24.6,2021/08/17(17:00)
2021,08,16,131330,95165,74559,20606,27.6,2021/08/16(20:00)
2021,08,15,131330,95825,68076,27749,40.8,2021/08/15(20:00)
2021,08,14,131330,96246,68470,27776,40.6,2021/08/14(20:00)
2021,08,13,131330,100125,81779,18346,22.4,2021/08/13(17:00)
2021,08,12,131330,98952,86355,12597,14.6,2021/08/12(17:00)
2021,08,11,131330,100800,83818,16982,20.3,2021/08/11(18:00)
2021,08,10,131330,100834,84877,15957,18.8,2021/08/10(17:00)
2021,08,09,131330,100772,84755,16017,18.9,2021/08/09(18:00)
2021,08,08,131330,94736,70201,24535,34.9,2021/08/08(20:00)
2021,08,07,131330,94901,75210,19691,26.2,2021/08/07(20:00)
2021,08,06,131330,99799,82367,17432,21.2,2021/08/06(17:00)
2021,08,05,131330,99341,85215,14126,16.6,2021/08/05(18:00)
2021,08,04,131330,99578,80073,19505,24.4,2021/08/04(18:00)
2021,08,03,131330,100181,77517,22664,29.2,2021/08/03(18:00)
2021,08,02,131330,98974,75460,23514,31.2,2021/08/02(18:00)
2021,08,01,131330,93539,72943,20596,28.2,2021/08/01(20:00)
2021,07,31,131330,92532,76776,15756,20.5,2021/07/31(20:00)
2021,07,30,131330,99390,87847,11543,13.1,2021/07/30(17:00)
2021,07,29,131330,101071,89634,11437,12.8,2021/07/29(17:00)
2021,07,28,131330,100846,90240,10606,11.8,2021/07/28(18:00)
2021,07,27,131330,100739,91141,9598,10.5,2021/07/27(18:00)
2021,07,26,131330,100633,89426,11207,12.5,2021/07/26(18:00)
2021,07,25,131330,95777,76521,19256,25.2,2021/07/25(20:00)
2021,07,24,131330,94507,78285,16222,20.7,2021/07/24(20:00)
2021,07,23,131330,99758,89812,9946,11.1,2021/07/23(17:00)
2021,07,22,131330,99955,89958,9997,11.1,2021/07/22(18:00)
2021,07,21,131069,99657,88937,10720,12.1,2021/07/21(17:00)
2021,07,20,131069,98376,87841,10535,12,2021/07/20(17:00)
2021,07,19,131069,98755,84586,14169,16.8,2021/07/19(17:00)
2021,07,18,131069,90453,72054,18399,25.5,2021/07/18(20:00)
2021,07,17,131069,91582,71849,19733,27.5,2021/07/17(20:00)
2021,07,16,131069,97850,88015,9835,11.2,2021/07/16(17:00)
2021,07,15,131069,98180,88551,9629,10.9,2021/07/15(17:00)
2021,07,14,131069,97475,88087,9388,10.7,2021/07/14(17:00)
2021,07,13,131069,95966,87172,8794,10.1,2021/07/13(17:00)
2021,07,12,131069,95006,85011,9995,11.8,2021/07/12(17:00)
2021,07,11,131069,93247,68518,24729,36.1,2021/07/11(20:00)
2021,07,10,131069,93577,67726,25851,38.2,2021/07/10(20:00)
2021,07,09,131069,95686,78397,17289,22.1,2021/07/09(18:00)
2021,07,08,131069,96234,81187,15047,18.5,2021/07/08(17:00)
2021,07,07,131069,95298,81086,14212,17.5,2021/07/07(16:00)
2021,07,06,131069,94417,79663,14754,18.5,2021/07/06(17:00)
2021,07,05,131069,95897,76256,19641,25.8,2021/07/05(17:00)
2021,07,04,131069,93065,62368,30697,49.2,2021/07/04(20:00)
2021,07,03,131069,90140,64612,25528,39.5,2021/07/03(15:00)
2021,07,02,131069,93498,76865,16633,21.6,2021/07/02(17:00)
2021,07,01,131069,94268,77476,16792,21.7,2021/07/01(17:00)
2021,06,30,131069,87887,74824,13063,17.5,2021/06/30(17:00)
2021,06,29,129623,87573,75854,11719,15.4,2021/06/29(17:00)
2021,06,28,129623,86121,74821,11300,15.1,2021/06/28(17:00)
2021,06,27,129623,82726,62109,20617,33.2,2021/06/27(21:00)
2021,06,26,129623,82911,62042,20869,33.6,2021/06/26(21:00)
2021,06,25,129623,84448,72763,11685,16.1,2021/06/25(17:00)
2021,06,24,129623,83428,72813,10615,14.6,2021/06/24(17:00)
2021,06,23,129623,86980,71726,15254,21.3,2021/06/23(17:00)
2021,06,22,129623,86284,72518,13766,19,2021/06/22(17:00)
2021,06,21,129623,85494,72382,13112,18.1,2021/06/21(18:00)
2021,06,20,129623,81141,61200,19941,32.6,2021/06/20(21:00)
2021,06,19,129623,80496,60923,19573,32.1,2021/06/19(21:00)
2021,06,18,129623,85313,70527,14786,21,2021/06/18(17:00)
2021,06,17,129623,84780,72670,12110,16.7,2021/06/17(17:00)
2021,06,16,129623,86430,72494,13936,19.2,2021/06/16(17:00)
2021,06,15,129623,84765,73311,11454,15.6,2021/06/15(15:00)
2021,06,14,129623,85516,74220,11296,15.2,2021/06/14(17:00)
2021,06,13,129623,83336,61518,21818,35.5,2021/06/13(20:00)
2021,06,12,129623,81677,62209,19468,31.3,2021/06/12(20:00)
2021,06,11,129623,84857,70071,14786,21.1,2021/06/11(10:00)
2021,06,10,129623,84887,74929,9958,13.3,2021/06/10(17:00)
2021,06,09,129623,85738,73387,12351,16.8,2021/06/09(17:00)
2021,06,08,129623,81135,69828,11307,16.2,2021/06/08(17:00)
2021,06,07,129623,80238,68543,11695,17.1,2021/06/07(18:00)
2021,06,06,129623,80130,58683,21447,36.5,2021/06/06(21:00)
2021,06,05,129623,80179,58611,21568,36.8,2021/06/05(21:00)
2021,06,04,129623,80802,64864,15938,24.6,2021/06/04(19:00)
2021,06,03,129623,79984,70113,9871,14.1,2021/06/03(15:00)
2021,06,02,129623,80613,68419,12194,17.8,2021/06/02(17:00)
2021,06,01,129623,81585,67332,14253,21.2,2021/06/01(17:00)
2021,05,31,129623,82530,66049,16481,25,2021/05/31(19:00)
2021,05,30,129623,81534,57041,24493,42.9,2021/05/30(21:00)
2021,05,29,129623,80035,57782,22253,38.5,2021/05/29(21:00)
2021,05,28,129623,81180,66069,15111,22.9,2021/05/28(14:00)
2021,05,27,129540,81164,67738,13426,19.8,2021/05/27(10:00)
2021,05,26,129540,82817,66876,15941,23.8,2021/05/26(17:00)
2021,05,25,129540,82567,65408,17159,26.2,2021/05/25(20:00)
2021,05,24,129540,80691,65847,14844,22.5,2021/05/24(20:00)
2021,05,23,129540,78777,56815,21962,38.7,2021/05/23(21:00)
2021,05,22,129540,78969,58452,20517,35.1,2021/05/22(21:00)
2021,05,21,129540,78706,65806,12900,19.6,2021/05/21(17:00)
2021,05,20,129540,80387,69140,11247,16.3,2021/05/20(17:00)
2021,05,19,129540,77651,62006,15645,25.2,2021/05/19(21:00)
2021,05,18,129540,80516,66240,14276,21.6,2021/05/18(20:00)
2021,05,17,129540,78759,68368,10391,15.2,2021/05/17(17:00)
2021,05,16,129540,73597,58503,15094,25.8,2021/05/16(20:00)
2021,05,15,129540,74083,60555,13528,22.3,2021/05/15(20:00)
2021,05,14,129540,78939,68888,10051,14.6,2021/05/14(17:00)
2021,05,13,128441,77778,67558,10220,15.1,2021/05/13(20:00)
2021,05,12,128441,76910,66063,10847,16.4,2021/05/12(20:00)
2021,05,11,128441,79515,66134,13381,20.2,2021/05/11(20:00)
2021,05,10,128441,78224,66682,11542,17.3,2021/05/10(16:00)
2021,05,09,128441,78634,56138,22496,40.1,2021/05/09(21:00)
2021,05,08,128441,80119,57311,22808,39.8,2021/05/08(21:00)
2021,05,07,128441,80942,64780,16162,24.9,2021/05/07(11:00)
2021,05,06,128441,80063,65436,14627,22.4,2021/05/06(20:00)
2021,05,05,128441,80360,60540,19820,32.7,2021/05/05(21:00)
2021,05,04,128441,79297,67838,11459,16.9,2021/05/04(17:00)
2021,05,03,128441,77344,65471,11873,18.1,2021/05/03(20:00)
2021,05,02,128441,75699,56721,18978,33.5,2021/05/02(21:00)
2021,05,01,128441,77837,56758,21079,37.1,2021/05/01(21:00)
2021,04,30,129361,78607,64304,14303,22.2,2021/04/30(20:00)
2021,04,29,129361,79393,66022,13371,20.3,2021/04/29(20:00)
2021,04,28,129361,79141,65551,13590,20.7,2021/04/28(20:00)
2021,04,27,129361,78696,66283,12413,18.7,2021/04/27(17:00)
2021,04,26,129361,77474,65456,12018,18.4,2021/04/26(20:00)
2021,04,25,129361,77491,56810,20681,36.4,2021/04/25(21:00)
2021,04,24,129361,75978,57782,18196,31.5,2021/04/24(20:00)
2021,04,23,129361,80306,65461,14845,22.7,2021/04/23(17:00)
2021,04,22,129361,79141,67265,11876,17.7,2021/04/22(17:00)
2021,04,21,129361,80595,65940,14655,22.2,2021/04/21(20:00)
2021,04,20,129361,80715,66393,14322,21.6,2021/04/20(20:00)
2021,04,19,129361,81777,66072,15705,23.8,2021/04/19(20:00)
2021,04,18,129361,79970,57397,22573,39.3,2021/04/18(21:00)
2021,04,17,129361,79926,58589,21337,36.4,2021/04/17(20:00)
2021,04,16,129361,80181,66009,14172,21.5,2021/04/16(09:00)
2021,04,15,129361,79439,66365,13074,19.7,2021/04/15(20:00)
2021,04,14,129361,79298,66263,13035,19.7,2021/04/14(20:00)
2021,04,13,129361,79998,66770,13228,19.8,2021/04/13(20:00)
2021,04,12,129361,77695,68966,8729,12.7,2021/04/12(17:00)
2021,04,11,129361,77347,56651,20696,36.5,2021/04/11(21:00)
2021,04,10,129361,77769,58226,19543,33.6,2021/04/10(20:00)
2021,04,09,129361,77866,65500,12366,18.9,2021/04/09(20:00)
2021,04,08,129361,78093,66706,11387,17.1,2021/04/08(20:00)
2021,04,07,129361,77395,66289,11106,16.8,2021/04/07(20:00)
2021,04,06,129361,76858,66622,10236,15.4,2021/04/06(20:00)
2021,04,05,129361,78663,66231,12432,18.8,2021/04/05(20:00)
2021,04,04,129361,77428,57780,19648,34,2021/04/04(20:00)
2021,04,03,129361,81169,59025,22144,37.5,2021/04/03(20:00)
2021,04,02,129361,86166,64600,21566,33.4,2021/04/02(20:00)
2021,04,01,129361,86161,66192,19969,30.2,2021/04/01(20:00)
2021,03,31,129114,87055,65755,21300,32.4,2021/03/31(20:00)
2021,03,30,129114,85885,66325,19560,29.5,2021/03/30(20:00)
2021,03,29,129114,84735,66819,17916,26.8,2021/03/29(20:00)
2021,03,28,129114,80393,57877,22516,38.9,2021/03/28(20:00)
2021,03,27,129114,79683,59268,20415,34.4,2021/03/27(20:00)
2021,03,26,129114,86356,66019,20337,30.8,2021/03/26(09:00)
2021,03,25,129114,86425,67429,18996,28.2,2021/03/25(20:00)
2021,03,24,129114,86499,68196,18303,26.8,2021/03/24(09:00)
2021,03,23,129114,86642,68079,18563,27.3,2021/03/23(20:00)
2021,03,22,129114,85853,68873,16980,24.7,2021/03/22(19:00)
2021,03,21,129114,85076,59578,25498,42.8,2021/03/21(20:00)
2021,03,20,129114,84474,61460,23014,37.4,2021/03/20(11:00)
2021,03,19,129114,87313,67369,19944,29.6,2021/03/19(09:00)
2021,03,18,129114,87913,68081,19832,29.1,2021/03/18(19:00)
2021,03,17,129114,88514,67684,20830,30.8,2021/03/17(20:00)
2021,03,16,129114,89360,68547,20813,30.4,2021/03/16(20:00)
2021,03,15,129114,89907,68220,21687,31.8,2021/03/15(19:00)
2021,03,14,129114,84416,58921,25495,43.3,2021/03/14(20:00)
2021,03,13,129114,83969,60715,23254,38.3,2021/03/13(01:00)
2021,03,12,129114,89744,73861,15883,21.5,2021/03/12(10:00)
2021,03,11,129114,89685,71172,18513,26,2021/03/11(09:00)
2021,03,10,129114,90175,70943,19232,27.1,2021/03/10(09:00)
2021,03,09,129114,90638,72893,17745,24.3,2021/03/09(09:00)
2021,03,08,129114,90377,71789,18588,25.9,2021/03/08(09:00)
2021,03,07,129114,86687,60702,25985,42.8,2021/03/07(20:00)
2021,03,06,129114,86139,62607,23532,37.6,2021/03/06(20:00)
2021,03,05,129114,90815,72682,18133,24.9,2021/03/05(09:00)
2021,03,04,129114,92010,76597,15413,20.1,2021/03/04(10:00)
2021,03,03,128820,90347,74748,15599,20.9,2021/03/03(09:00)
2021,03,02,128820,92526,77208,15318,19.8,2021/03/02(10:00)
2021,03,01,128820,91305,64904,26401,40.7,2021/03/01(19:00)
2021,02,28,128820,87376,59511,27865,46.8,2021/02/28(20:00)
2021,02,27,128820,90533,61810,28723,46.5,2021/02/27(01:00)
2021,02,26,128820,93769,73253,20516,28,2021/02/26(09:00)
2021,02,25,128820,94462,77701,16761,21.6,2021/02/25(11:00)
2021,02,24,128820,94726,76281,18445,24.2,2021/02/24(10:00)
2021,02,23,128820,96003,73896,22107,29.9,2021/02/23(09:00)
2021,02,22,128820,95782,70422,25360,36,2021/02/22(19:00)
2021,02,21,128820,90791,60140,30651,51,2021/02/21(20:00)
2021,02,20,128820,91578,64603,26975,41.8,2021/02/20(01:00)
2021,02,19,128820,95171,79299,15872,20,2021/02/19(09:00)
2021,02,18,128820,96048,84067,11981,14.3,2021/02/18(10:00)
2021,02,17,128820,95992,84749,11243,13.3,2021/02/17(10:00)
2021,02,16,128820,95044,80711,14333,17.8,2021/02/16(17:00)
2021,02,15,128820,94473,74829,19644,26.3,2021/02/15(11:00)
2021,02,14,128820,88705,57687,31018,53.8,2021/02/14(20:00)
2021,02,13,128820,87762,55686,32076,57.6,2021/02/13(20:00)
2021,02,12,128820,86404,54836,31568,57.6,2021/02/12(24:00)
2021,02,11,128820,92479,61009,31470,51.6,2021/02/11(01:00)
2021,02,10,128820,95532,76269,19263,25.3,2021/02/10(09:00)
2021,02,09,128820,95302,79114,16188,20.5,2021/02/09(09:00)
2021,02,08,128820,95887,77950,17937,23,2021/02/08(19:00)
2021,02,07,128820,97339,63698,33641,52.8,2021/02/07(20:00)
2021,02,06,128820,95591,66340,29251,44.1,2021/02/06(09:00)
2021,02,05,128820,98078,80698,17380,21.5,2021/02/05(10:00)
2021,02,04,128820,99356,80804,18552,23,2021/02/04(10:00)
2021,02,03,128820,98639,82594,16045,19.4,2021/02/03(09:00)
2021,02,02,128820,100311,80457,19854,24.7,2021/02/02(18:00)
2021,02,01,128820,97244,77878,19366,24.9,2021/02/01(10:00)
2021,01,31,128820,97006,63574,33432,52.6,2021/01/31(19:00)
2021,01,30,128820,97640,69215,28425,41.1,2021/01/30(01:00)
2021,01,29,128820,100187,83971,16216,19.3,2021/01/29(10:00)
2021,01,28,128820,99431,80655,18776,23.3,2021/01/28(17:00)
2021,01,27,128209,98753,77213,21540,27.9,2021/01/27(09:00)
2021,01,26,128209,98918,79190,19728,24.9,2021/01/26(11:00)
2021,01,25,128209,99244,75047,24197,32.2,2021/01/25(09:00)
2021,01,24,128209,95387,62201,33186,53.4,2021/01/24(19:00)
2021,01,23,128209,93433,65370,28063,42.9,2021/01/23(11:00)
2021,01,22,128209,97449,79367,18082,22.8,2021/01/22(10:00)
2021,01,21,128209,98432,80435,17997,22.4,2021/01/21(17:00)
2021,01,20,128209,99678,83468,16210,19.4,2021/01/20(09:00)
2021,01,19,128209,101789,85348,16441,19.3,2021/01/19(10:00)
2021,01,18,128209,100962,86673,14289,16.5,2021/01/18(11:00)
2021,01,17,128209,96509,68310,28199,41.3,2021/01/17(19:00)
2021,01,16,128209,95981,69347,26634,38.4,2021/01/16(19:00)
2021,01,15,128209,97229,78869,18360,23.3,2021/01/15(10:00)
2021,01,14,128209,97618,80757,16861,20.9,2021/01/14(09:00)
2021,01,13,128209,97325,84235,13090,15.5,2021/01/13(10:00)
2021,01,12,128209,98911,88089,10822,12.3,2021/01/12(10:00)
2021,01,11,128209,99189,90564,8625,9.5,2021/01/11(11:00)
2021,01,10,128209,92072,70738,21334,30.2,2021/01/10(19:00)
2021,01,09,128209,92949,74232,18717,25.2,2021/01/09(19:00)
2021,01,08,128209,98229,89858,8371,9.3,2021/01/08(11:00)
2021,01,07,128209,98213,90195,8018,8.9,2021/01/07(17:00)
2021,01,06,128209,98015,85568,12447,14.5,2021/01/06(10:00)
2021,01,05,128209,97905,84497,13408,15.9,2021/01/05(17:00)
2021,01,04,128209,97246,82840,14406,17.4,2021/01/04(17:00)
2021,01,03,128209,96591,66473,30118,45.3,2021/01/03(19:00)
2021,01,02,128209,97800,64982,32818,50.5,2021/01/02(19:00)
2021,01,01,128209,98477,64942,33535,51.6,2021/01/01(01:00)
2020,12,31,129191,99506,80632,18874,23.4,2020/12/31(10:00)
2020,12,30,129191,99290,83916,15374,18.3,2020/12/30(10:00)
2020,12,29,129191,98175,78915,19260,24.4,2020/12/29(17:00)
2020,12,28,128609,96902,76803,20099,26.2,2020/12/28(10:00)
2020,12,27,128609,92923,62840,30083,47.9,2020/12/27(19:00)
2020,12,26,128609,92990,63604,29386,46.2,2020/12/26(19:00)
2020,12,25,128609,94583,67327,27256,40.5,2020/12/25(19:00)
2020,12,24,128609,94665,77124,17541,22.7,2020/12/24(10:00)
2020,12,23,128609,96337,81349,14988,18.4,2020/12/23(10:00)
2020,12,22,128609,94909,82109,12800,15.6,2020/12/22(10:00)
2020,12,21,128609,95863,82906,12957,15.6,2020/12/21(10:00)
2020,12,20,128609,92484,66560,25924,38.9,2020/12/20(19:00)
2020,12,19,128609,94556,69628,24928,35.8,2020/12/19(19:00)
2020,12,18,128609,97067,82899,14168,17.1,2020/12/18(10:00)
2020,12,17,128609,97476,84185,13291,15.8,2020/12/17(10:00)
2020,12,16,128609,98795,85132,13663,16,2020/12/16(17:00)
2020,12,15,128609,97585,84708,12877,15.2,2020/12/15(17:00)
2020,12,14,128609,96126,84182,11944,14.2,2020/12/14(17:00)
2020,12,13,128609,90985,63683,27302,42.9,2020/12/13(19:00)
2020,12,12,128609,88706,64485,24221,37.6,2020/12/12(19:00)
2020,12,11,128609,91288,77669,13619,17.5,2020/12/11(10:00)
2020,12,10,128609,91022,80497,10525,13.1,2020/12/10(10:00)
2020,12,09,128609,92162,78544,13618,17.3,2020/12/09(10:00)
2020,12,08,128609,90949,78234,12715,16.3,2020/12/08(17:00)
2020,12,07,128609,89207,78832,10375,13.2,2020/12/07(10:00)
2020,12,06,128609,86824,62314,24510,39.3,2020/12/06(19:00)
2020,12,05,128609,87545,64555,22990,35.6,2020/12/05(19:00)
2020,12,04,128609,90619,76916,13703,17.8,2020/12/04(10:00)
2020,12,03,128609,90134,76904,13230,17.2,2020/12/03(18:00)
2020,12,02,128609,90125,77722,12403,16,2020/12/02(10:00)
2020,12,01,128609,89162,76210,12952,17,2020/12/01(17:00)
2020,11,30,128609,96827,77074,19753,25.6,2020/11/30(17:00)
2020,11,29,128609,94989,62162,32827,52.8,2020/11/29(19:00)
2020,11,28,128609,94835,63912,30923,48.4,2020/11/28(19:00)
2020,11,27,128609,95242,73588,21654,29.4,2020/11/27(17:00)
2020,11,26,128197,91860,73798,18062,24.5,2020/11/26(10:00)
2020,11,25,128197,93638,72888,20750,28.5,2020/11/25(17:00)
2020,11,24,128197,92402,73988,18414,24.9,2020/11/24(10:00)
2020,11,23,128197,90650,73234,17416,23.8,2020/11/23(18:00)
2020,11,22,128197,91702,59194,32508,54.9,2020/11/22(19:00)
2020,11,21,128197,90106,60121,29985,49.9,2020/11/21(19:00)
2020,11,20,128197,89056,71916,17140,23.8,2020/11/20(17:00)
2020,11,19,128197,87933,70905,17028,24,2020/11/19(15:00)
2020,11,18,128197,88630,69555,19075,27.4,2020/11/18(17:00)
2020,11,17,128197,87217,69082,18135,26.3,2020/11/17(17:00)
2020,11,16,128197,84560,68154,16406,24.1,2020/11/16(17:00)
2020,11,15,128197,86174,57555,28619,49.7,2020/11/15(19:00)
2020,11,14,128197,85450,58858,26592,45.2,2020/11/14(19:00)
2020,11,13,128197,85827,67692,18135,26.8,2020/11/13(09:00)
2020,11,12,128197,86645,68011,18634,27.4,2020/11/12(19:00)
2020,11,11,128197,86307,67954,18353,27,2020/11/11(09:00)
2020,11,10,128197,87738,68952,18786,27.2,2020/11/10(19:00)
2020,11,09,128197,87391,69999,17392,24.8,2020/11/09(17:00)
2020,11,08,128197,88167,57536,30631,53.2,2020/11/08(19:00)
2020,11,07,128197,86552,58540,28012,47.9,2020/11/07(19:00)
2020,11,06,128197,86273,69596,16677,24,2020/11/06(10:00)
2020,11,05,128197,84703,68907,15796,22.9,2020/11/05(17:00)
2020,11,04,128197,84201,69231,14970,21.6,2020/11/04(18:00)
2020,11,03,128197,84039,69570,14469,20.8,2020/11/03(18:00)
2020,11,02,128197,83707,66720,16987,25.5,2020/11/02(19:00)
2020,11,01,128197,82297,56822,25475,44.8,2020/11/01(19:00)
2020,10,31,128197,83503,57719,25784,44.7,2020/10/31(19:00)
2020,10,30,128197,87749,66037,21712,32.9,2020/10/30(19:00)
2020,10,29,128197,86310,67410,18900,28,2020/10/29(19:00)
2020,10,28,127762,84286,66752,17534,26.3,2020/10/28(19:00)
2020,10,27,127762,83430,67660,15770,23.3,2020/10/27(19:00)
2020,10,26,127762,85565,67680,17885,26.4,2020/10/26(19:00)
2020,10,25,127762,86531,57288,29243,51,2020/10/25(19:00)
2020,10,24,127762,87472,59213,28259,47.7,2020/10/24(19:00)
2020,10,23,127762,88205,67147,21058,31.4,2020/10/23(19:00)
2020,10,22,127762,86805,68374,18431,27,2020/10/22(19:00)
2020,10,21,127762,85999,68454,17545,25.6,2020/10/21(17:00)
2020,10,20,127762,86336,67824,18512,27.3,2020/10/20(19:00)
2020,10,19,128562,86637,67545,19092,28.3,2020/10/19(19:00)
2020,10,18,128562,86593,57306,29287,51.1,2020/10/18(20:00)
2020,10,17,128562,86170,59231,26939,45.5,2020/10/17(19:00)
2020,10,16,128562,88445,67349,21096,31.3,2020/10/16(19:00)
2020,10,15,128562,87965,67771,20194,29.8,2020/10/15(19:00)
2020,10,14,128562,87900,67364,20536,30.5,2020/10/14(19:00)
2020,10,13,128562,87140,67755,19385,28.6,2020/10/13(19:00)
2020,10,12,128562,87545,67195,20350,30.3,2020/10/12(19:00)
2020,10,11,128562,87356,57139,30217,52.9,2020/10/11(20:00)
2020,10,10,128562,85805,57877,27928,48.3,2020/10/10(19:00)
2020,10,09,128562,84994,62608,22386,35.8,2020/10/09(19:00)
2020,10,08,128562,85846,66261,19585,29.6,2020/10/08(19:00)
2020,10,07,128562,83795,66722,17073,25.6,2020/10/07(19:00)
2020,10,06,128562,83948,66935,17013,25.4,2020/10/06(19:00)
2020,10,05,128562,82923,65238,17685,27.1,2020/10/05(19:00)
2020,10,04,128562,84967,55638,29329,52.7,2020/10/04(19:00)
2020,10,03,128562,83911,53653,30258,56.4,2020/10/03(19:00)
2020,10,02,128562,83813,51651,32162,62.3,2020/10/02(20:00)
2020,10,01,128562,83392,48946,34446,70.4,2020/10/01(20:00)
2020,09,30,128562,85437,51986,33451,64.3,2020/09/30(19:00)
2020,09,29,128562,85624,60187,25437,42.3,2020/09/29(19:00)
2020,09,28,128562,86570,66036,20534,31.1,2020/09/28(19:00)
2020,09,27,128562,84816,58397,26419,45.2,2020/09/27(20:00)
2020,09,26,128562,82264,59397,22867,38.5,2020/09/26(20:00)
2020,09,25,128562,83744,67826,15918,23.5,2020/09/25(17:00)
2020,09,24,128078,85023,69151,15872,23,2020/09/24(17:00)
2020,09,23,128078,85480,68298,17182,25.2,2020/09/23(17:00)
2020,09,22,128078,85522,68157,17365,25.5,2020/09/22(19:00)
2020,09,21,128078,85529,67626,17903,26.5,2020/09/21(19:00)
2020,09,20,128078,87008,58261,28747,49.3,2020/09/20(20:00)
2020,09,19,128078,84851,59888,24963,41.7,2020/09/19(20:00)
2020,09,18,128078,89897,68259,21638,31.7,2020/09/18(17:00)
2020,09,17,128078,88228,71725,16503,23,2020/09/17(15:00)
2020,09,16,128078,87437,73144,14293,19.5,2020/09/16(17:00)
2020,09,15,128078,87732,73146,14586,19.9,2020/09/15(17:00)
2020,09,14,128078,88674,70702,17972,25.4,2020/09/14(17:00)
2020,09,13,128078,86405,59480,26925,45.3,2020/09/13(20:00)
2020,09,12,128078,85586,60966,24620,40.4,2020/09/12(20:00)
2020,09,11,128078,89004,73473,15531,21.1,2020/09/11(15:00)
2020,09,10,128078,89827,72738,17089,23.5,2020/09/10(17:00)
2020,09,09,128078,90356,71515,18841,26.3,2020/09/09(17:00)
2020,09,08,128078,91007,73153,17854,24.4,2020/09/08(17:00)
2020,09,07,128078,90928,69547,21381,30.7,2020/09/07(17:00)
2020,09,06,128078,91524,59566,31958,53.7,2020/09/06(20:00)
2020,09,05,128078,88098,61835,26263,42.5,2020/09/05(15:00)
2020,09,04,128078,92606,73772,18834,25.5,2020/09/04(17:00)
2020,09,03,128078,93299,74636,18663,25,2020/09/03(17:00)
2020,09,02,128078,96522,81356,15166,18.6,2020/09/02(15:00)
2020,09,01,128078,96797,82036,14761,18,2020/09/01(17:00)
2020,08,31,128078,98469,82673,15796,19.1,2020/08/31(17:00)
2020,08,30,128078,97818,71466,26352,36.9,2020/08/30(20:00)
2020,08,29,128078,94365,72836,21529,29.6,2020/08/29(15:00)
2020,08,28,128078,98247,85677,12570,14.7,2020/08/28(17:00)
2020,08,27,127819,98377,84961,13416,15.8,2020/08/27(17:00)
2020,08,26,127819,97951,89091,8860,9.9,2020/08/26(15:00)
2020,08,25,127819,97899,88574,9325,10.5,2020/08/25(17:00)
2020,08,24,127819,98291,85076,13215,15.5,2020/08/24(17:00)
2020,08,23,127819,97178,68538,28640,41.8,2020/08/23(20:00)
2020,08,22,127819,97583,69559,28024,40.3,2020/08/22(14:00)
2020,08,21,127819,99830,84425,15405,18.2,2020/08/21(17:00)
2020,08,20,127819,98613,86967,11646,13.4,2020/08/20(17:00)
2020,08,19,127819,99866,86698,13168,15.2,2020/08/19(17:00)
2020,08,18,127819,98698,86324,12374,14.3,2020/08/18(18:00)
2020,08,17,127819,97376,78553,18823,24,2020/08/17(19:00)
2020,08,16,127819,97669,70452,27217,38.6,2020/08/16(20:00)
2020,08,15,127819,97614,72195,25419,35.2,2020/08/15(20:00)
2020,08,14,127819,99312,82639,16673,20.2,2020/08/14(17:00)
2020,08,13,127819,99086,83777,15309,18.3,2020/08/13(17:00)
2020,08,12,127819,97600,82122,15478,18.8,2020/08/12(17:00)
2020,08,11,127819,97735,79148,18587,23.5,2020/08/11(15:00)
2020,08,10,127819,97823,80229,17594,21.9,2020/08/10(15:00)
2020,08,09,127819,98702,65302,33400,51.1,2020/08/09(20:00)
2020,08,08,127819,96841,64649,32192,49.8,2020/08/08(12:00)
2020,08,07,127819,98278,72986,25292,34.7,2020/08/07(15:00)
2020,08,06,127819,98650,73160,25490,34.8,2020/08/06(12:00)
2020,08,05,127819,98490,72543,25947,35.8,2020/08/05(14:00)
2020,08,04,127819,98627,71617,27010,37.7,2020/08/04(18:00)
2020,08,03,127819,97969,68035,29934,44,2020/08/03(16:00)
2020,08,02,127819,97712,62345,35367,56.7,2020/08/02(20:00)
2020,08,01,127819,97532,62900,34632,55.1,2020/08/01(20:00)
2020,07,31,127819,97643,72400,25243,34.9,2020/07/31(17:00)
2020,07,30,127819,97773,72981,24792,34,2020/07/30(17:00)
2020,07,29,127819,97376,73525,23851,32.4,2020/07/29(15:00)
2020,07,28,127819,96278,73747,22531,30.6,2020/07/28(17:00)
2020,07,27,127819,95989,73006,22983,31.5,2020/07/27(17:00)
2020,07,26,127819,96604,60578,36026,59.5,2020/07/26(21:00)
2020,07,25,127819,96250,59890,36360,60.7,2020/07/25(21:00)
2020,07,24,127819,95911,69401,26510,38.2,2020/07/24(15:00)
2020,07,23,127819,97026,72543,24483,33.7,2020/07/23(15:00)
2020,07,22,127819,95809,74111,21698,29.3,2020/07/22(15:00)
2020,07,21,127819,97779,74450,23329,31.3,2020/07/21(17:00)
2020,07,20,127338,98419,73800,24619,33.4,2020/07/20(11:00)
2020,07,19,127338,95880,62377,33503,53.7,2020/07/19(21:00)
2020,07,18,127338,97009,61204,35805,58.5,2020/07/18(21:00)
2020,07,17,127338,99492,71418,28074,39.3,2020/07/17(17:00)
2020,07,16,127338,100269,70509,29760,42.2,2020/07/16(17:00)
2020,07,15,127338,99753,68952,30801,44.7,2020/07/15(17:00)
2020,07,14,127338,99756,68457,31299,45.7,2020/07/14(17:00)
2020,07,13,127338,99746,68771,30975,45,2020/07/13(17:00)
2020,07,12,127338,98333,58411,39922,68.3,2020/07/12(20:00)
2020,07,11,127338,96925,61501,35424,57.6,2020/07/11(20:00)
2020,07,10,127338,97930,72503,25427,35.1,2020/07/10(17:00)
2020,07,09,127338,97338,75675,21663,28.6,2020/07/09(17:00)
2020,07,08,127338,98039,74371,23668,31.8,2020/07/08(17:00)
2020,07,07,127338,99029,72265,26764,37,2020/07/07(17:00)
2020,07,06,127338,96795,73331,23464,32,2020/07/06(17:00)
2020,07,05,127338,94623,58879,35744,60.7,2020/07/05(21:00)
2020,07,04,127338,90430,58241,32189,55.3,2020/07/04(21:00)
2020,07,03,127338,93248,69956,23292,33.3,2020/07/03(15:00)
2020,07,02,127338,95513,70435,25078,35.6,2020/07/02(17:00)
2020,07,01,127338,93570,67510,26060,38.6,2020/07/01(17:00)
2020,06,30,127338,96204,67390,28814,42.8,2020/06/30(17:00)
2020,06,29,127153,93710,71580,22130,30.9,2020/06/29(15:00)
2020,06,28,127153,94649,58627,36022,61.4,2020/06/28(21:00)
2020,06,27,127153,94225,59168,35057,59.2,2020/06/27(21:00)
2020,06,26,127153,94508,67237,27271,40.6,2020/06/26(17:00)
2020,06,25,127153,92616,70436,22180,31.5,2020/06/25(15:00)
2020,06,24,127153,94036,71085,22951,32.3,2020/06/24(11:00)
2020,06,23,127153,93139,74580,18559,24.9,2020/06/23(17:00)
2020,06,22,127153,92668,74046,18622,25.1,2020/06/22(17:00)
2020,06,21,127153,91226,58769,32457,55.2,2020/06/21(21:00)
2020,06,20,127153,90621,58749,31872,54.3,2020/06/20(21:00)
2020,06,19,127153,91543,67881,23662,34.9,2020/06/19(17:00)
2020,06,18,126798,88958,68208,20750,30.4,2020/06/18(15:00)
2020,06,17,126798,86671,71113,15558,21.9,2020/06/17(17:00)
2020,06,16,126798,88932,70355,18577,26.4,2020/06/16(17:00)
2020,06,15,126798,90337,68945,21392,31,2020/06/15(17:00)
2020,06,14,126798,89401,58071,31330,54,2020/06/14(21:00)
2020,06,13,126798,89021,61765,27256,44.1,2020/06/13(20:00)
2020,06,12,126798,90658,71925,18733,26,2020/06/12(17:00)
2020,06,11,126798,91127,72458,18669,25.8,2020/06/11(17:00)
2020,06,10,126798,91874,75247,16627,22.1,2020/06/10(17:00)
2020,06,09,126798,91007,73065,17942,24.6,2020/06/09(17:00)
2020,06,08,126798,93424,70986,22438,31.6,2020/06/08(17:00)
2020,06,07,126798,93095,56738,36357,64.1,2020/06/07(21:00)
2020,06,06,126798,90868,57796,33072,57.2,2020/06/06(21:00)
2020,06,05,126798,91841,67093,24748,36.9,2020/06/05(17:00)
2020,06,04,126798,90830,67908,22922,33.8,2020/06/04(17:00)
2020,06,03,126798,93068,66004,27064,41,2020/06/03(17:00)
2020,06,02,126798,92482,64274,28208,43.9,2020/06/02(17:00)
2020,06,01,126798,93552,62505,31047,49.7,2020/06/01(18:00)
2020,05,31,126798,91572,53975,37597,69.7,2020/05/31(21:00)
2020,05,30,126580,93168,54866,38302,69.8,2020/05/30(21:00)
2020,05,29,126580,93465,61765,31700,51.3,2020/05/29(17:00)
2020,05,28,126580,94699,61697,33002,53.5,2020/05/28(18:00)
2020,05,27,126580,93280,61192,32088,52.4,2020/05/27(20:00)
2020,05,26,126580,94878,62836,32042,51,2020/05/26(18:00)
2020,05,25,126580,94923,62174,32749,52.7,2020/05/25(17:00)
2020,05,24,126580,96012,54457,41555,76.3,2020/05/24(21:00)
2020,05,23,126580,94866,54830,40036,73,2020/05/23(21:00)
2020,05,22,126580,91340,61067,30273,49.6,2020/05/22(17:00)
2020,05,21,126580,90663,61329,29334,47.8,2020/05/21(20:00)
2020,05,20,126580,91454,61065,30389,49.8,2020/05/20(20:00)
2020,05,19,126580,92441,63817,28624,44.9,2020/05/19(11:00)
2020,05,18,126580,88211,65700,22511,34.3,2020/05/18(17:00)
2020,05,17,126580,90211,55310,34901,63.1,2020/05/17(21:00)
2020,05,16,126580,87257,54733,32524,59.4,2020/05/16(21:00)
2020,05,15,126580,88356,64508,23848,37,2020/05/15(11:00)
2020,05,14,126580,88998,62498,26500,42.4,2020/05/14(17:00)
2020,05,13,126580,89183,61203,27980,45.7,2020/05/13(20:00)
2020,05,12,126580,88047,61820,26227,42.4,2020/05/12(20:00)
2020,05,11,126580,86688,61467,25221,41,2020/05/11(20:00)
2020,05,10,126580,88343,54608,33735,61.8,2020/05/10(21:00)
2020,05,09,126580,87591,55520,32071,57.8,2020/05/09(12:00)
2020,05,08,126580,90233,62506,27727,44.4,2020/05/08(17:00)
2020,05,07,126580,88789,62127,26662,42.9,2020/05/07(20:00)
2020,05,06,126262,89731,61479,28252,46,2020/05/06(20:00)
2020,05,05,126262,91397,56310,35087,62.3,2020/05/05(21:00)
2020,05,04,126262,91579,57080,34499,60.4,2020/05/04(20:00)
2020,05,03,126262,91563,53877,37686,69.9,2020/05/03(21:00)
2020,05,02,126262,92659,52776,39883,75.6,2020/05/02(20:00)
2020,05,01,126262,92948,53435,39513,73.9,2020/05/01(21:00)
2020,04,30,126262,93909,55855,38054,68.1,2020/04/30(21:00)
2020,04,29,126262,91654,59574,32080,53.8,2020/04/29(20:00)
2020,04,28,126262,90838,61242,29596,48.3,2020/04/28(20:00)
2020,04,27,126262,90357,62669,27688,44.2,2020/04/27(20:00)
2020,04,26,126262,89516,54785,34731,63.4,2020/04/26(21:00)
2020,04,25,126262,88784,56341,32443,57.6,2020/04/25(01:00)
2020,04,24,126262,88897,62099,26798,43.2,2020/04/24(20:00)
2020,04,23,126262,85634,64118,21516,33.6,2020/04/23(20:00)
2020,04,22,126262,86202,63868,22334,35,2020/04/22(20:00)
2020,04,21,126262,85926,64403,21523,33.4,2020/04/21(20:00)
2020,04,20,126262,84130,64906,19224,29.6,2020/04/20(17:00)
2020,04,19,126262,83068,56027,27041,48.3,2020/04/19(20:00)
2020,04,18,126262,81674,55711,25963,46.6,2020/04/18(01:00)
2020,04,17,126262,83368,66699,16669,25,2020/04/17(10:00)
2020,04,16,126262,83416,63018,20398,32.4,2020/04/16(20:00)
2020,04,15,126262,85381,59614,25767,43.2,2020/04/15(20:00)
2020,04,14,126262,85438,62808,22630,36,2020/04/14(20:00)
2020,04,13,126262,87519,64411,23108,35.9,2020/04/13(20:00)
2020,04,12,126262,87889,56211,31678,56.4,2020/04/12(20:00)
2020,04,11,126262,88341,56756,31585,55.7,2020/04/11(20:00)
2020,04,10,126262,89377,63376,26001,41,2020/04/10(20:00)
2020,04,09,126262,89866,64862,25004,38.5,2020/04/09(20:00)
2020,04,08,125887,91327,64227,27100,42.2,2020/04/08(20:00)
2020,04,07,125887,90860,64082,26778,41.8,2020/04/07(20:00)
2020,04,06,125887,91182,64714,26468,40.9,2020/04/06(20:00)
2020,04,05,125887,90878,56568,34310,60.7,2020/04/05(20:00)
2020,04,04,125887,91190,57117,34073,59.7,2020/04/04(01:00)
2020,04,03,125887,92166,63334,28832,45.5,2020/04/03(20:00)
2020,04,02,125887,92581,64793,27788,42.9,2020/04/02(20:00)
2020,04,01,125887,92044,65397,26647,40.7,2020/04/01(10:00)
2020,03,31,125887,86469,64045,22424,35,2020/03/31(20:00)
2020,03,30,125887,86752,64310,22442,34.9,2020/03/30(20:00)
2020,03,29,125887,83156,56117,27039,48.2,2020/03/29(20:00)
2020,03,28,125887,83711,57706,26005,45.1,2020/03/28(20:00)
2020,03,27,125887,85189,67487,17702,26.2,2020/03/27(10:00)
2020,03,26,125887,83727,66984,16743,25,2020/03/26(17:00)
2020,03,25,125887,84385,64440,19945,31,2020/03/25(20:00)
2020,03,24,125887,84829,65456,19373,29.6,2020/03/24(20:00)
2020,03,23,125887,84764,65294,19470,29.8,2020/03/23(20:00)
2020,03,22,125887,84330,56264,28066,49.9,2020/03/22(20:00)
2020,03,21,125887,85555,58825,26730,45.4,2020/03/21(01:00)
2020,03,20,125887,89277,65269,24008,36.8,2020/03/20(09:00)
2020,03,19,125887,88786,68829,19957,29,2020/03/19(10:00)
2020,03,18,125887,88257,67700,20557,30.4,2020/03/18(09:00)
2020,03,17,125887,89602,70633,18969,26.9,2020/03/17(10:00)
2020,03,16,125887,89903,69166,20737,30,2020/03/16(19:00)
2020,03,15,125887,86578,59745,26833,44.9,2020/03/15(20:00)
2020,03,14,125887,85307,61420,23887,38.9,2020/03/14(01:00)
2020,03,13,125887,89983,69141,20842,30.1,2020/03/13(09:00)
2020,03,12,125887,90698,69187,21511,31.1,2020/03/12(09:00)
2020,03,11,125887,91229,69189,22040,31.9,2020/03/11(19:00)
2020,03,10,125887,90877,73329,17548,23.9,2020/03/10(11:00)
2020,03,09,125887,90748,69348,21400,30.9,2020/03/09(10:00)
2020,03,08,125887,87904,57799,30105,52.1,2020/03/08(20:00)
2020,03,07,125887,87952,61624,26328,42.7,2020/03/07(11:00)
2020,03,06,125887,91029,70461,20568,29.2,2020/03/06(09:00)
2020,03,05,125887,91190,71279,19911,27.9,2020/03/05(09:00)
2020,03,04,125887,92449,71207,21242,29.8,2020/03/04(19:00)
2020,03,03,125887,92536,69937,22599,32.3,2020/03/03(09:00)
2020,03,02,125887,93738,70171,23567,33.6,2020/03/02(19:00)
2020,03,01,125887,90853,59052,31801,53.9,2020/03/01(20:00)
2020,02,29,125887,92676,61341,31335,51.1,2020/02/29(01:00)
2020,02,28,125887,93914,74398,19516,26.2,2020/02/28(11:00)
2020,02,27,125887,93785,70327,23458,33.4,2020/02/27(09:00)
2020,02,26,125887,94390,72005,22385,31.1,2020/02/26(10:00)
2020,02,25,125887,94728,76417,18311,24,2020/02/25(11:00)
2020,02,24,125887,96071,71041,25030,35.2,2020/02/24(10:00)
2020,02,23,125887,96379,60988,35391,58,2020/02/23(20:00)
2020,02,22,125887,96245,62123,34122,54.9,2020/02/22(24:00)
2020,02,21,125887,96738,73398,23340,31.8,2020/02/21(10:00)
2020,02,20,125887,95750,74510,21240,28.5,2020/02/20(09:00)
2020,02,19,125887,96894,77972,18922,24.3,2020/02/19(10:00)
2020,02,18,125887,96863,80338,16525,20.6,2020/02/18(10:00)
2020,02,17,125887,97039,80648,16391,20.3,2020/02/17(11:00)
2020,02,16,125887,96078,63497,32581,51.3,2020/02/16(20:00)
2020,02,15,125887,93364,60935,32429,53.2,2020/02/15(01:00)
2020,02,14,125887,95318,72476,22842,31.5,2020/02/14(10:00)
2020,02,13,125887,95029,74042,20987,28.3,2020/02/13(10:00)
2020,02,12,125358,93859,77688,16171,20.8,2020/02/12(11:00)
2020,02,11,125358,94879,75830,19049,25.1,2020/02/11(10:00)
2020,02,10,125358,95475,76445,19030,24.9,2020/02/10(10:00)
2020,02,09,125358,96834,62873,33961,54,2020/02/09(20:00)
2020,02,08,125358,95448,65470,29978,45.8,2020/02/08(01:00)
2020,02,07,125358,96718,79761,16957,21.3,2020/02/07(10:00)
2020,02,06,125358,97069,81493,15576,19.1,2020/02/06(10:00)
2020,02,05,125358,97018,80770,16248,20.1,2020/02/05(10:00)
2020,02,04,125358,96258,77877,18381,23.6,2020/02/04(09:00)
2020,02,03,125358,95400,76775,18625,24.3,2020/02/03(10:00)
2020,02,02,125358,95485,61882,33603,54.3,2020/02/02(20:00)
2020,02,01,125358,94104,63369,30735,48.5,2020/02/01(01:00)
2020,01,31,125358,95312,75262,20050,26.6,2020/01/31(10:00)
2020,01,30,125358,95263,74457,20806,27.9,2020/01/30(10:00)
2020,01,29,125358,94774,76016,18758,24.7,2020/01/29(10:00)
2020,01,28,125358,93600,72476,21124,29.1,2020/01/28(10:00)
2020,01,27,125358,91781,59961,31820,53.1,2020/01/27(19:00)
2020,01,26,125358,91368,55281,36087,65.3,2020/01/26(24:00)
2020,01,25,125358,92307,54692,37615,68.8,2020/01/25(24:00)
2020,01,24,125358,94657,60789,33868,55.7,2020/01/24(01:00)
2020,01,23,125358,95986,76229,19757,25.9,2020/01/23(10:00)
2020,01,22,125358,94816,81438,13378,16.4,2020/01/22(01:00)
2020,01,21,125358,95606,79627,15979,20.1,2020/01/21(10:00)
2020,01,20,125358,94545,78922,15623,19.8,2020/01/20(10:00)
2020,01,19,125358,92976,64497,28479,44.2,2020/01/19(19:00)
2020,01,18,125358,91928,67399,24529,36.4,2020/01/18(09:00)
2020,01,17,125358,94484,81303,13181,16.2,2020/01/17(10:00)
2020,01,16,125358,94735,82352,12383,15,2020/01/16(10:00)
2020,01,15,125353,95018,81195,13823,17,2020/01/15(10:00)
2020,01,14,125353,94425,82329,12096,14.7,2020/01/14(10:00)
2020,01,13,125333,94946,80242,14704,18.3,2020/01/13(10:00)
2020,01,12,125333,93783,64008,29775,46.5,2020/01/12(19:00)
2020,01,11,125333,93323,66148,27175,41.1,2020/01/11(01:00)
2020,01,10,125333,95000,79247,15753,19.9,2020/01/10(10:00)
2020,01,09,125333,96303,79160,17143,21.7,2020/01/09(10:00)
2020,01,08,125333,95463,79002,16461,20.8,2020/01/08(11:00)
2020,01,07,125333,94123,80147,13976,17.4,2020/01/07(11:00)
2020,01,06,125333,93842,81890,11952,14.6,2020/01/06(11:00)
2020,01,05,125333,93438,63231,30207,47.8,2020/01/05(19:00)
2020,01,04,125333,94481,65628,28853,44,2020/01/04(01:00)
2020,01,03,125333,96134,78269,17865,22.8,2020/01/03(10:00)
2020,01,02,125333,95372,77180,18192,23.6,2020/01/02(10:00)
2020,01,01,125333,96804,64007,32797,51.2,2020/01/01(01:00)
2019,12,31,125338,97035,76223,20812,27.3,2019/12/31(10:00)
2019,12,30,124854,93749,75158,18591,24.7,2019/12/30(10:00)
2019,12,29,124854,94005,62540,31465,50.3,2019/12/29(19:00)
2019,12,28,124854,93308,65014,28294,43.5,2019/12/28(01:00)
2019,12,27,124854,93985,78548,15437,19.7,2019/12/27(10:00)
2019,12,26,124854,92905,79431,13474,17,2019/12/26(11:00)
2019,12,25,124854,92654,65610,27044,41.2,2019/12/25(19:00)
2019,12,24,124854,92536,79456,13080,16.5,2019/12/24(10:00)
2019,12,23,124854,91375,78779,12596,16,2019/12/23(10:00)
2019,12,22,124854,89528,62827,26701,42.5,2019/12/22(19:00)
2019,12,21,124854,88121,66564,21557,32.4,2019/12/21(11:00)
2019,12,20,124854,90896,79158,11738,14.8,2019/12/20(10:00)
2019,12,19,124854,91402,77689,13713,17.7,2019/12/19(10:00)
2019,12,18,124854,91281,77666,13615,17.5,2019/12/18(10:00)
2019,12,17,124833,90041,77487,12554,16.2,2019/12/17(10:00)
2019,12,16,124833,90759,76425,14334,18.8,2019/12/16(10:00)
2019,12,15,124833,89090,61405,27685,45.1,2019/12/15(19:00)
2019,12,14,124833,89108,64861,24247,37.4,2019/12/14(01:00)
2019,12,13,124833,93576,79110,14466,18.3,2019/12/13(10:00)
2019,12,12,124833,92176,78241,13935,17.8,2019/12/12(09:00)
2019,12,11,124833,89968,76860,13108,17.1,2019/12/11(10:00)
2019,12,10,124833,90073,79201,10872,13.7,2019/12/10(10:00)
2019,12,09,124833,91032,80600,10432,12.9,2019/12/09(10:00)
2019,12,08,124833,88512,64092,24420,38.1,2019/12/08(19:00)
2019,12,07,124833,88596,67875,20721,30.5,2019/12/07(01:00)
2019,12,06,124833,92934,81787,11147,13.6,2019/12/06(10:00)
2019,12,05,124833,90748,80251,10497,13.1,2019/12/05(18:00)
2019,12,04,124833,88239,76624,11615,15.2,2019/12/04(10:00)
2019,12,03,124392,88648,77950,10698,13.7,2019/12/03(17:00)
2019,12,02,124392,89693,76453,13240,17.3,2019/12/02(18:00)
2019,12,01,124392,85920,60978,24942,40.9,2019/12/01(19:00)
2019,11,30,124392,88910,62203,26707,42.9,2019/11/30(01:00)
2019,11,29,124392,89896,73720,16176,21.9,2019/11/29(09:00)
2019,11,28,124392,87908,73693,14215,19.3,2019/11/28(10:00)
2019,11,27,124392,87376,73684,13692,18.6,2019/11/27(17:00)
2019,11,26,124392,89075,72776,16299,22.4,2019/11/26(10:00)
2019,11,25,124392,89691,74250,15441,20.8,2019/11/25(17:00)
2019,11,24,124392,83730,57696,26034,45.1,2019/11/24(19:00)
2019,11,23,124392,83834,60030,23804,39.7,2019/11/23(01:00)
2019,11,22,124392,88001,71571,16430,23,2019/11/22(09:00)
2019,11,21,124392,88463,74041,14422,19.5,2019/11/21(09:00)
2019,11,20,124392,86728,74148,12580,17,2019/11/20(09:00)
2019,11,19,124392,87377,74393,12984,17.5,2019/11/19(17:00)
2019,11,18,124392,88940,71848,17092,23.8,2019/11/18(17:00)
2019,11,17,124392,85545,58646,26899,45.9,2019/11/17(19:00)
2019,11,16,124392,85664,60421,25243,41.8,2019/11/16(01:00)
2019,11,15,124392,86729,70876,15853,22.4,2019/11/15(10:00)
2019,11,14,124392,87748,72026,15722,21.8,2019/11/14(18:00)
2019,11,13,124392,85826,71244,14582,20.5,2019/11/13(17:00)
2019,11,12,124023,86750,68342,18408,26.9,2019/11/12(18:00)
2019,11,11,124023,85649,67084,18565,27.7,2019/11/11(19:00)
2019,11,10,124023,83166,57626,25540,44.3,2019/11/10(19:00)
2019,11,09,124023,84573,58848,25725,43.7,2019/11/09(01:00)
2019,11,08,124023,88048,66895,21153,31.6,2019/11/08(17:00)
2019,11,07,124023,88250,66635,21615,32.4,2019/11/07(19:00)
2019,11,06,124023,85861,65837,20024,30.4,2019/11/06(17:00)
2019,11,05,124023,85099,66471,18628,28,2019/11/05(19:00)
2019,11,04,124023,85676,65979,19697,29.9,2019/11/04(17:00)
2019,11,03,124023,86064,56036,30028,53.6,2019/11/03(19:00)
2019,11,02,124023,85945,56973,28972,50.9,2019/11/02(19:00)
2019,11,01,124023,85949,65117,20832,32,2019/11/01(17:00)
2019,10,31,124023,82886,66888,15998,23.9,2019/10/31(19:00)
2019,10,30,124023,81982,66526,15456,23.2,2019/10/30(19:00)
2019,10,29,124023,82395,67119,15276,22.8,2019/10/29(19:00)
2019,10,28,122490,82434,66673,15761,23.6,2019/10/28(19:00)
2019,10,27,122490,84834,56033,28801,51.4,2019/10/27(20:00)
2019,10,26,122490,83846,57066,26780,46.9,2019/10/26(19:00)
2019,10,25,122490,82728,65970,16758,25.4,2019/10/25(18:00)
2019,10,24,122490,82482,66741,15741,23.6,2019/10/24(19:00)
2019,10,23,122490,81763,67006,14757,22,2019/10/23(17:00)
2019,10,22,122490,81746,67468,14278,21.2,2019/10/22(19:00)
2019,10,21,122490,80786,66898,13888,20.8,2019/10/21(19:00)
2019,10,20,122490,82594,56578,26016,46,2019/10/20(20:00)
2019,10,19,122490,79662,57570,22092,38.4,2019/10/19(19:00)
2019,10,18,122490,82388,66319,16069,24.2,2019/10/18(17:00)
2019,10,17,122490,81826,65896,15930,24.2,2019/10/17(19:00)
2019,10,16,122490,82263,65339,16924,25.9,2019/10/16(19:00)
2019,10,15,122490,81374,66840,14534,21.7,2019/10/15(19:00)
2019,10,14,122490,80774,66445,14329,21.6,2019/10/14(19:00)
2019,10,13,122490,84062,56189,27873,49.6,2019/10/13(20:00)
2019,10,12,122490,79668,56963,22705,39.9,2019/10/12(19:00)
2019,10,11,122490,80279,65826,14453,22,2019/10/11(19:00)
2019,10,10,122490,80267,66814,13453,20.1,2019/10/10(19:00)
2019,10,09,122490,81179,62364,18815,30.2,2019/10/09(20:00)
2019,10,08,122490,82189,66068,16121,24.4,2019/10/08(19:00)
2019,10,07,122490,82629,67701,14928,22,2019/10/07(17:00)
2019,10,06,122490,83945,56929,27016,47.5,2019/10/06(20:00)
2019,10,05,122490,81526,58463,23063,39.4,2019/10/05(11:00)
2019,10,04,122490,80662,69517,11145,16,2019/10/04(17:00)
2019,10,03,122490,81703,65389,16314,24.9,2019/10/03(19:00)
2019,10,02,122490,85176,72674,12502,17.2,2019/10/02(15:00)
2019,10,01,122490,83471,73550,9921,13.5,2019/10/01(17:00)
2019,09,30,122490,84371,72703,11668,16,2019/09/30(17:00)
2019,09,29,122490,84097,59910,24187,40.4,2019/09/29(20:00)
2019,09,28,122490,83347,61652,21695,35.2,2019/09/28(20:00)
2019,09,27,122490,84363,70695,13668,19.3,2019/09/27(17:00)
2019,09,26,122490,84644,70942,13702,19.3,2019/09/26(17:00)
2019,09,25,122490,84067,69484,14583,21,2019/09/25(17:00)
2019,09,24,122490,87436,68030,19406,28.5,2019/09/24(17:00)
2019,09,23,122490,87757,67955,19802,29.1,2019/09/23(17:00)
2019,09,22,122490,85676,57175,28501,49.8,2019/09/22(20:00)
2019,09,21,122490,83252,60423,22829,37.8,2019/09/21(20:00)
2019,09,20,122490,89961,68997,20964,30.4,2019/09/20(17:00)
2019,09,19,122490,90289,71203,19086,26.8,2019/09/19(17:00)
2019,09,18,122490,90221,71310,18911,26.5,2019/09/18(17:00)
2019,09,17,122490,88944,72654,16290,22.4,2019/09/17(17:00)
2019,09,16,122490,88841,71926,16915,23.5,2019/09/16(17:00)
2019,09,15,122490,87737,58401,29336,50.2,2019/09/15(20:00)
2019,09,14,122490,87824,55077,32747,59.5,2019/09/14(20:00)
2019,09,13,122490,87867,50583,37284,73.7,2019/09/13(20:00)
2019,09,12,122490,89300,55025,34275,62.3,2019/09/12(01:00)
2019,09,11,122490,92360,73271,19089,26.1,2019/09/11(11:00)
2019,09,10,122490,91977,78650,13327,16.9,2019/09/10(17:00)
2019,09,09,122973,92717,78980,13737,17.4,2019/09/09(17:00)
2019,09,08,122973,92823,65686,27137,41.3,2019/09/08(20:00)
2019,09,07,122973,94243,68972,25271,36.6,2019/09/07(12:00)
2019,09,06,122973,96032,79916,16116,20.2,2019/09/06(17:00)
2019,09,05,122973,96786,79390,17396,21.9,2019/09/05(15:00)
2019,09,04,122973,95358,77939,17419,22.3,2019/09/04(17:00)
2019,09,03,122973,95152,77067,18085,23.5,2019/09/03(15:00)
2019,09,02,122973,96412,76231,20181,26.5,2019/09/02(17:00)
2019,09,01,122973,97308,61847,35461,57.3,2019/09/01(20:00)
2019,08,31,122973,97968,63393,34575,54.5,2019/08/31(20:00)
2019,08,30,122973,99882,73735,26147,35.5,2019/08/30(17:00)
2019,08,29,121147,99833,76683,23150,30.2,2019/08/29(11:00)
2019,08,28,121147,99232,79037,20195,25.6,2019/08/28(17:00)
2019,08,27,121147,99787,77998,21789,27.9,2019/08/27(17:00)
2019,08,26,121147,99869,79478,20391,25.7,2019/08/26(17:00)
2019,08,25,121147,98253,63326,34927,55.2,2019/08/25(20:00)
2019,08,24,121147,98115,64735,33380,51.6,2019/08/24(15:00)
2019,08,23,121147,100326,79012,21314,27,2019/08/23(17:00)
2019,08,22,121147,100471,82264,18207,22.1,2019/08/22(17:00)
2019,08,21,121147,99640,83782,15858,18.9,2019/08/21(17:00)
2019,08,20,121147,98607,83162,15445,18.6,2019/08/20(17:00)
2019,08,19,121147,98558,81590,16968,20.8,2019/08/19(17:00)
2019,08,18,121147,96791,66051,30740,46.5,2019/08/18(20:00)
2019,08,17,121147,96653,68337,28316,41.4,2019/08/17(17:00)
2019,08,16,121147,98046,81147,16899,20.8,2019/08/16(17:00)
2019,08,15,121147,96663,75693,20970,27.7,2019/08/15(15:00)
2019,08,14,121147,98540,90052,8488,9.4,2019/08/14(17:00)
2019,08,13,121147,96389,90314,6075,6.7,2019/08/13(17:00)
2019,08,12,121147,97108,86941,10167,11.7,2019/08/12(17:00)
2019,08,11,121147,94097,73304,20793,28.4,2019/08/11(20:00)
2019,08,10,121147,93371,75211,18160,24.1,2019/08/10(20:00)
2019,08,09,121147,97267,85400,11867,13.9,2019/08/09(17:00)
2019,08,08,121147,97218,84356,12862,15.2,2019/08/08(15:00)
2019,08,07,121147,98026,81077,16949,20.9,2019/08/07(17:00)
2019,08,06,121147,97597,82491,15106,18.3,2019/08/06(17:00)
2019,08,05,121147,97013,82885,14128,17,2019/08/05(17:00)
2019,08,04,121147,95160,70852,24308,34.3,2019/08/04(21:00)
2019,08,03,121147,94116,70485,23631,33.5,2019/08/03(17:00)
2019,08,02,121147,97519,77913,19606,25.2,2019/08/02(18:00)
2019,08,01,121147,97699,77967,19732,25.3,2019/08/01(18:00)
2019,07,31,121147,97185,78182,19003,24.3,2019/07/31(17:00)
2019,07,30,121147,97149,81567,15582,19.1,2019/07/30(17:00)
2019,07,29,121147,97017,80114,16903,21.1,2019/07/29(17:00)
2019,07,28,121147,95524,67137,28387,42.3,2019/07/28(21:00)
2019,07,27,121147,96160,71548,24612,34.4,2019/07/27(14:00)
2019,07,26,121147,97280,80943,16337,20.2,2019/07/26(15:00)
2019,07,25,121147,96927,82349,14578,17.7,2019/07/25(15:00)
2019,07,24,121147,97332,82716,14616,17.7,2019/07/24(15:00)
2019,07,23,121147,95593,84164,11429,13.6,2019/07/23(17:00)
2019,07,22,121147,97038,81923,15115,18.5,2019/07/22(17:00)
2019,07,21,121147,94528,64826,29702,45.8,2019/07/21(21:00)
2019,07,20,121147,94148,68096,26052,38.3,2019/07/20(15:00)
2019,07,19,121147,95691,81037,14654,18.1,2019/07/19(15:00)
2019,07,18,121147,95445,78538,16907,21.5,2019/07/18(17:00)
2019,07,17,121147,95420,77875,17545,22.5,2019/07/17(17:00)
2019,07,16,121147,94626,77005,17621,22.9,2019/07/16(17:00)
2019,07,15,121147,94590,75227,19363,25.7,2019/07/15(17:00)
2019,07,14,121147,93017,62384,30633,49.1,2019/07/14(21:00)
2019,07,13,121147,93081,62192,30889,49.7,2019/07/13(21:00)
2019,07,12,121147,94222,73720,20502,27.8,2019/07/12(17:00)
2019,07,11,121147,95381,73762,21619,29.3,2019/07/11(15:00)
2019,07,10,121147,95999,73582,22417,30.5,2019/07/10(15:00)
2019,07,09,121147,94279,74847,19432,26,2019/07/09(15:00)
2019,07,08,121147,94434,74511,19923,26.7,2019/07/08(17:00)
2019,07,07,121147,92607,61231,31376,51.2,2019/07/07(21:00)
2019,07,06,121147,91649,64664,26985,41.7,2019/07/06(20:00)
2019,07,05,121147,94391,77081,17310,22.5,2019/07/05(17:00)
2019,07,04,121147,93946,75978,17968,23.6,2019/07/04(17:00)
2019,07,03,121147,92712,74051,18661,25.2,2019/07/03(15:00)
2019,07,02,121147,92227,73871,18356,24.8,2019/07/02(17:00)
2019,07,01,121147,91817,73799,18018,24.4,2019/07/01(17:00)
2019,06,30,121147,87921,60661,27260,44.9,2019/06/30(21:00)
2019,06,29,121147,87932,61863,26069,42.1,2019/06/29(12:00)
2019,06,28,120471,90337,73877,16460,22.3,2019/06/28(17:00)
2019,06,27,120471,90520,75206,15314,20.4,2019/06/27(17:00)
2019,06,26,120471,89983,72691,17292,23.8,2019/06/26(15:00)
2019,06,25,120471,89869,74192,15677,21.1,2019/06/25(17:00)
2019,06,24,120471,90467,72358,18109,25,2019/06/24(17:00)
2019,06,23,120471,88127,58504,29623,50.6,2019/06/23(21:00)
2019,06,22,120471,88896,59611,29285,49.1,2019/06/22(21:00)
2019,06,21,120471,90556,71392,19164,26.8,2019/06/21(17:00)
2019,06,20,120471,90492,72419,18073,25,2019/06/20(17:00)
2019,06,19,120471,89717,71045,18672,26.3,2019/06/19(17:00)
2019,06,18,120471,90120,70283,19837,28.2,2019/06/18(17:00)
2019,06,17,120471,89409,69144,20265,29.3,2019/06/17(17:00)
2019,06,16,120471,86679,57589,29090,50.5,2019/06/16(21:00)
2019,06,15,120471,87091,58299,28792,49.4,2019/06/15(21:00)
2019,06,14,120471,88949,70094,18855,26.9,2019/06/14(17:00)
2019,06,13,120471,88551,69302,19249,27.8,2019/06/13(16:00)
2019,06,12,120471,88232,68360,19872,29.1,2019/06/12(17:00)
2019,06,11,119826,88715,67125,21590,32.2,2019/06/11(17:00)
2019,06,10,119826,87694,67097,20597,30.7,2019/06/10(17:00)
2019,06,09,119826,87928,56627,31301,55.3,2019/06/09(21:00)
2019,06,08,119826,88149,57222,30927,54,2019/06/08(21:00)
2019,06,07,119826,92817,65956,26861,40.7,2019/06/07(15:00)
2019,06,06,119826,90589,65996,24593,37.3,2019/06/06(15:00)
2019,06,05,119826,90898,70897,20001,28.2,2019/06/05(17:00)
2019,06,04,119826,90564,70611,19953,28.3,2019/06/04(17:00)
2019,06,03,119826,88900,69235,19665,28.4,2019/06/03(17:00)
2019,06,02,119826,87594,56758,30836,54.3,2019/06/02(21:00)
2019,06,01,119826,88112,56860,31252,55,2019/06/01(21:00)
2019,05,31,119826,87936,64992,22944,35.3,2019/05/31(17:00)
2019,05,30,119826,85645,68850,16795,24.4,2019/05/30(17:00)
2019,05,29,119826,85854,67474,18380,27.2,2019/05/29(17:00)
2019,05,28,119826,85268,66168,19100,28.9,2019/05/28(17:00)
2019,05,27,119826,86044,69700,16344,23.4,2019/05/27(15:00)
2019,05,26,119826,81999,57613,24386,42.3,2019/05/26(21:00)
2019,05,25,119826,82940,58952,23988,40.7,2019/05/25(21:00)
2019,05,24,119826,86270,70964,15306,21.6,2019/05/24(17:00)
2019,05,23,119826,85870,68535,17335,25.3,2019/05/23(17:00)
2019,05,22,119826,85640,66689,18951,28.4,2019/05/22(17:00)
2019,05,21,119826,84904,65571,19333,29.5,2019/05/21(17:00)
2019,05,20,119826,85532,64838,20694,31.9,2019/05/20(10:00)
2019,05,19,119826,85663,57545,28118,48.9,2019/05/19(21:00)
2019,05,18,119826,86935,58102,28833,49.6,2019/05/18(21:00)
2019,05,17,119826,85369,69583,15786,22.7,2019/05/17(17:00)
2019,05,16,119826,83421,69631,13790,19.8,2019/05/16(17:00)
2019,05,15,119826,80361,68076,12285,18,2019/05/15(17:00)
2019,05,14,119826,80697,66716,13981,21,2019/05/14(17:00)
2019,05,13,119826,80443,66385,14058,21.2,2019/05/13(17:00)
2019,05,12,119826,79573,55971,23602,42.2,2019/05/12(21:00)
2019,05,11,119826,79703,56737,22966,40.5,2019/05/11(21:00)
2019,05,10,119826,81679,65051,16628,25.6,2019/05/10(17:00)
2019,05,09,119826,80556,64637,15919,24.6,2019/05/09(20:00)
2019,05,08,119826,78364,65191,13173,20.2,2019/05/08(17:00)
2019,05,07,119826,79503,64119,15384,24,2019/05/07(21:00)
2019,05,06,119826,81530,59232,22298,37.6,2019/05/06(21:00)
2019,05,05,119826,79335,54877,24458,44.6,2019/05/05(21:00)
2019,05,04,119826,80918,55891,25027,44.8,2019/05/04(21:00)
2019,05,03,119826,81989,63488,18501,29.1,2019/05/03(17:00)
2019,05,02,119826,82415,64347,18068,28.1,2019/05/02(20:00)
2019,05,01,119826,81645,59257,22388,37.8,2019/05/01(21:00)
2019,04,30,119826,82853,65866,16987,25.8,2019/04/30(10:00)
2019,04,29,119826,82947,68904,14043,20.4,2019/04/29(15:00)
2019,04,28,119826,80878,56304,24574,43.6,2019/04/28(21:00)
2019,04,27,119826,82324,58248,24076,41.3,2019/04/27(01:00)
2019,04,26,119826,84099,68703,15396,22.4,2019/04/26(17:00)
2019,04,25,119826,83514,68406,15108,22.1,2019/04/25(17:00)
2019,04,24,119826,82852,66843,16009,24,2019/04/24(17:00)
2019,04,23,119826,81557,67676,13881,20.5,2019/04/23(17:00)
2019,04,22,119826,81942,65036,16906,26,2019/04/22(17:00)
2019,04,21,119826,83152,56357,26795,47.5,2019/04/21(01:00)
2019,04,20,119826,85289,57536,27753,48.2,2019/04/20(01:00)
2019,04,19,119826,84424,67286,17138,25.5,2019/04/19(10:00)
2019,04,18,119826,82853,65665,17188,26.2,2019/04/18(20:00)
2019,04,17,119826,82570,64858,17712,27.3,2019/04/17(09:00)
2019,04,16,119826,83106,65846,17260,26.2,2019/04/16(20:00)
2019,04,15,119826,85512,65652,19860,30.3,2019/04/15(20:00)
2019,04,14,119826,82158,57347,24811,43.3,2019/04/14(21:00)
2019,04,13,119826,83129,58741,24388,41.5,2019/04/13(01:00)
2019,04,12,119826,86705,65841,20864,31.7,2019/04/12(09:00)
2019,04,11,119826,85487,68823,16664,24.2,2019/04/11(10:00)
2019,04,10,119826,86455,73010,13445,18.4,2019/04/10(10:00)
2019,04,09,119826,87976,70499,17477,24.8,2019/04/09(17:00)
2019,04,08,119826,86824,66789,20035,30,2019/04/08(20:00)
2019,04,07,119826,85169,57246,27923,48.8,2019/04/07(20:00)
2019,04,06,119826,85244,59799,25445,42.6,2019/04/06(01:00)
2019,04,05,119826,88423,69788,18635,26.7,2019/04/05(10:00)
2019,04,04,119826,88395,68612,19783,28.8,2019/04/04(09:00)
2019,04,03,119826,89340,68911,20429,29.6,2019/04/03(09:00)
2019,04,02,119826,89630,69375,20255,29.2,2019/04/02(20:00)
2019,04,01,119826,89580,68918,20662,30,2019/04/01(20:00)
2019,03,31,119826,91010,59005,32005,54.2,2019/03/31(20:00)
2019,03,30,119826,90805,59993,30812,51.4,2019/03/30(24:00)
2019,03,29,119826,89996,67957,22039,32.4,2019/03/29(09:00)
2019,03,28,119826,87696,68576,19120,27.9,2019/03/28(09:00)
2019,03,27,119826,88343,68679,19664,28.6,2019/03/27(10:00)
2019,03,26,119350,88814,70390,18424,26.2,2019/03/26(09:00)
2019,03,25,119350,88593,72375,16218,22.4,2019/03/25(10:00)
2019,03,24,119350,90705,59274,31431,53,2019/03/24(20:00)
2019,03,23,119350,89921,62029,27892,45,2019/03/23(01:00)
2019,03,22,119350,90789,71617,19172,26.8,2019/03/22(09:00)
2019,03,21,119350,89654,71884,17770,24.7,2019/03/21(10:00)
2019,03,20,119350,88590,71675,16915,23.6,2019/03/20(10:00)
2019,03,19,119350,89997,70866,19131,27,2019/03/19(09:00)
2019,03,18,119350,89700,72008,17692,24.6,2019/03/18(10:00)
2019,03,17,119350,91088,59480,31608,53.1,2019/03/17(20:00)
2019,03,16,119350,91308,63088,28220,44.7,2019/03/16(01:00)
2019,03,15,119350,91330,73568,17762,24.1,2019/03/15(10:00)
2019,03,14,119350,91332,73378,17954,24.5,2019/03/14(09:00)
2019,03,13,119350,90422,74136,16286,22,2019/03/13(10:00)
2019,03,12,119350,90181,73773,16408,22.2,2019/03/12(10:00)
2019,03,11,119350,90487,72149,18338,25.4,2019/03/11(10:00)
2019,03,10,119350,90342,59584,30758,51.6,2019/03/10(20:00)
2019,03,09,119350,90590,62527,28063,44.9,2019/03/09(01:00)
2019,03,08,119350,91780,72390,19390,26.8,2019/03/08(09:00)
2019,03,07,119350,90568,72780,17788,24.4,2019/03/07(10:00)
2019,03,06,119350,90340,73573,16767,22.8,2019/03/06(10:00)
2019,03,05,119350,89577,73603,15974,21.7,2019/03/05(10:00)
2019,03,04,119350,91523,71880,19643,27.3,2019/03/04(20:00)
2019,03,03,119350,93415,59211,34204,57.8,2019/03/03(20:00)
2019,03,02,119350,93202,60563,32639,53.9,2019/03/02(24:00)
2019,03,01,119350,91637,63532,28105,44.2,2019/03/01(20:00)
2019,02,28,119350,96915,73115,23800,32.6,2019/02/28(10:00)
2019,02,27,119350,96168,74792,21376,28.6,2019/02/27(10:00)
2019,02,26,119350,96495,74488,22007,29.5,2019/02/26(10:00)
2019,02,25,119350,93529,74848,18681,25,2019/02/25(10:00)
2019,02,24,119350,92101,60881,31220,51.3,2019/02/24(24:00)
2019,02,23,119350,94747,65016,29731,45.7,2019/02/23(01:00)
2019,02,22,119350,95280,77656,17624,22.7,2019/02/22(10:00)
2019,02,21,119350,97508,78291,19217,24.5,2019/02/21(10:00)
2019,02,20,119350,97769,79777,17992,22.6,2019/02/20(10:00)
2019,02,19,119350,98738,82869,15869,19.1,2019/02/19(11:00)
2019,02,18,119350,97919,80394,17525,21.8,2019/02/18(10:00)
2019,02,17,119350,96719,64033,32686,51,2019/02/17(24:00)
2019,02,16,119350,95215,67769,27446,40.5,2019/02/16(11:00)
2019,02,15,119350,98165,81471,16694,20.5,2019/02/15(10:00)
2019,02,14,119350,98101,81477,16624,20.4,2019/02/14(10:00)
2019,02,13,119350,98297,80849,17448,21.6,2019/02/13(10:00)
2019,02,12,119350,98910,81684,17226,21.1,2019/02/12(10:00)
2019,02,11,119350,98662,81369,17293,21.3,2019/02/11(10:00)
2019,02,10,119350,97303,65225,32078,49.2,2019/02/10(19:00)
2019,02,09,119350,98259,67498,30761,45.6,2019/02/09(24:00)
2019,02,08,119350,99739,79253,20486,25.8,2019/02/08(10:00)
2019,02,07,119350,97979,72824,25155,34.5,2019/02/07(10:00)
2019,02,06,119350,95737,56835,38902,68.4,2019/02/06(24:00)
2019,02,05,119350,94577,55340,39237,70.9,2019/02/05(24:00)
2019,02,04,119350,94102,57603,36499,63.4,2019/02/04(01:00)
2019,02,03,119350,96030,60334,35696,59.2,2019/02/03(01:00)
2019,02,02,119350,96386,67202,29184,43.4,2019/02/02(01:00)
2019,02,01,119350,99950,80556,19394,24.1,2019/02/01(10:00)
2019,01,31,119350,99590,83652,15938,19.1,2019/01/31(11:00)
2019,01,30,119350,99728,80741,18987,23.5,2019/01/30(10:00)
2019,01,29,119350,100298,81215,19083,23.5,2019/01/29(10:00)
2019,01,28,119350,99745,80399,19346,24.1,2019/01/28(10:00)
2019,01,27,119350,97470,65189,32281,49.5,2019/01/27(01:00)
2019,01,26,119350,97796,68954,28842,41.8,2019/01/26(09:00)
2019,01,25,119350,99688,81007,18681,23.1,2019/01/25(10:00)
2019,01,24,119350,99535,80239,19296,24,2019/01/24(10:00)
2019,01,23,119092,100337,80794,19543,24.2,2019/01/23(10:00)
2019,01,22,119092,100320,81134,19186,23.6,2019/01/22(10:00)
2019,01,21,119092,99530,82668,16862,20.4,2019/01/21(10:00)
2019,01,20,119092,99561,65830,33731,51.2,2019/01/20(24:00)
2019,01,19,119092,99028,67950,31078,45.7,2019/01/19(01:00)
2019,01,18,119092,101500,81668,19832,24.3,2019/01/18(10:00)
2019,01,17,119092,101011,82611,18400,22.3,2019/01/17(10:00)
2019,01,16,119092,101806,84401,17405,20.6,2019/01/16(10:00)
2019,01,15,119092,98347,81378,16969,20.9,2019/01/15(10:00)
2019,01,14,119092,98333,81783,16550,20.2,2019/01/14(10:00)
2019,01,13,119092,97990,64545,33445,51.8,2019/01/13(24:00)
2019,01,12,119092,98303,68147,30156,44.3,2019/01/12(11:00)
2019,01,11,119092,99990,81941,18049,22,2019/01/11(10:00)
2019,01,10,119092,101064,83833,17231,20.6,2019/01/10(10:00)
2019,01,09,119092,100827,85392,15435,18.1,2019/01/09(10:00)
2019,01,08,119092,100948,83818,17130,20.4,2019/01/08(10:00)
2019,01,07,119092,101091,84074,17017,20.2,2019/01/07(10:00)
2019,01,06,119092,98748,66493,32255,48.5,2019/01/06(20:00)
2019,01,05,119092,99505,69496,30009,43.2,2019/01/05(11:00)
2019,01,04,119092,100294,84746,15548,18.3,2019/01/04(10:00)
2019,01,03,119092,99695,84196,15499,18.4,2019/01/03(10:00)
2019,01,02,119092,101149,82437,18712,22.7,2019/01/02(10:00)
2019,01,01,119092,100043,65493,34550,52.8,2019/01/01(24:00)
2018,12,31,119092,101763,74652,27111,36.3,2018/12/31(10:00)
2018,12,30,119092,98344,67295,31049,46.1,2018/12/30(19:00)
2018,12,29,119092,99181,71171,28010,39.4,2018/12/29(01:00)
2018,12,28,119092,100841,86083,14758,17.1,2018/12/28(10:00)
2018,12,27,119092,101923,84377,17546,20.8,2018/12/27(17:00)
2018,12,26,119092,101432,79897,21535,27,2018/12/26(10:00)
2018,12,25,119092,99769,67836,31933,47.1,2018/12/25(19:00)
2018,12,24,119092,100733,77453,23280,30.1,2018/12/24(10:00)
2018,12,23,119092,98751,63817,34934,54.7,2018/12/23(24:00)
2018,12,22,119092,94130,65656,28474,43.4,2018/12/22(09:00)
2018,12,21,119092,96871,79490,17381,21.9,2018/12/21(10:00)
2018,12,20,119092,97431,81081,16350,20.2,2018/12/20(10:00)
2018,12,19,118266,97325,80550,16775,20.8,2018/12/19(10:00)
2018,12,18,118266,95992,81939,14053,17.2,2018/12/18(10:00)
2018,12,17,118266,96268,81991,14277,17.4,2018/12/17(10:00)
2018,12,16,118266,95867,65711,30156,45.9,2018/12/16(19:00)
2018,12,15,118266,97154,70400,26754,38,2018/12/15(01:00)
2018,12,14,118266,98032,83871,14161,16.9,2018/12/14(10:00)
2018,12,13,118266,97903,83702,14201,17,2018/12/13(10:00)
2018,12,12,118266,97110,83447,13663,16.4,2018/12/12(10:00)
2018,12,11,118266,98271,85463,12808,15,2018/12/11(11:00)
2018,12,10,118266,97775,83776,13999,16.7,2018/12/10(10:00)
2018,12,09,118266,95642,67263,28379,42.2,2018/12/09(19:00)
2018,12,08,118266,95541,69510,26031,37.4,2018/12/08(01:00)
2018,12,07,118266,96189,82072,14117,17.2,2018/12/07(17:00)
2018,12,06,118266,94062,78157,15905,20.4,2018/12/06(10:00)
2018,12,05,118266,95421,76287,19134,25.1,2018/12/05(10:00)
2018,12,04,118266,95299,73600,21699,29.5,2018/12/04(10:00)
2018,12,03,118266,93342,73728,19614,26.6,2018/12/03(10:00)
2018,12,02,118266,91105,60232,30873,51.3,2018/12/02(19:00)
2018,12,01,118266,93351,63484,29867,47,2018/12/01(01:00)
2018,11,30,118266,94970,74676,20294,27.2,2018/11/30(10:00)
2018,11,29,118266,93480,75914,17566,23.1,2018/11/29(10:00)
2018,11,28,118266,92262,74495,17767,23.8,2018/11/28(10:00)
2018,11,27,118266,91509,74408,17101,23,2018/11/27(10:00)
2018,11,26,118266,90334,74393,15941,21.4,2018/11/26(10:00)
2018,11,25,118266,88825,60418,28407,47,2018/11/25(19:00)
2018,11,24,118266,89340,66283,23057,34.8,2018/11/24(11:00)
2018,11,23,118266,89284,74515,14769,19.8,2018/11/23(10:00)
2018,11,22,118266,89678,73930,15748,21.3,2018/11/22(18:00)
2018,11,21,118266,88807,74205,14602,19.7,2018/11/21(17:00)
2018,11,20,118266,89359,72086,17273,24,2018/11/20(09:00)
2018,11,19,118266,89749,71325,18424,25.8,2018/11/19(18:00)
2018,11,18,118266,88836,59566,29270,49.1,2018/11/18(19:00)
2018,11,17,118266,89280,60668,28612,47.2,2018/11/17(01:00)
2018,11,16,117996,89388,71160,18228,25.6,2018/11/16(10:00)
2018,11,15,117996,88965,69041,19924,28.9,2018/11/15(18:00)
2018,11,14,117996,87850,69403,18447,26.6,2018/11/14(09:00)
2018,11,13,117996,88097,69176,18921,27.4,2018/11/13(01:00)
2018,11,12,117996,88116,67888,20228,29.8,2018/11/12(10:00)
2018,11,11,117996,85994,58243,27751,47.6,2018/11/11(19:00)
2018,11,10,117996,85852,59583,26269,44.1,2018/11/10(01:00)
2018,11,09,117996,88746,69575,19171,27.6,2018/11/09(10:00)
2018,11,08,117996,88392,71046,17346,24.4,2018/11/08(15:00)
2018,11,07,117996,86002,70063,15939,22.7,2018/11/07(10:00)
2018,11,06,117996,86299,68452,17847,26.1,2018/11/06(10:00)
2018,11,05,117996,85339,68082,17257,25.3,2018/11/05(19:00)
2018,11,04,117996,83304,58032,25272,43.5,2018/11/04(20:00)
2018,11,03,117996,84461,59940,24521,40.9,2018/11/03(01:00)
2018,11,02,117996,86318,68213,18105,26.5,2018/11/02(09:00)
2018,11,01,117996,85019,69302,15717,22.7,2018/11/01(19:00)
2018,10,31,117996,84708,69211,15497,22.4,2018/10/31(19:00)
2018,10,30,117996,84796,70329,14467,20.6,2018/10/30(19:00)
2018,10,29,117996,84867,69629,15238,21.9,2018/10/29(19:00)
2018,10,28,117996,80886,57363,23523,41,2018/10/28(20:00)
2018,10,27,117996,78853,59055,19798,33.5,2018/10/27(19:00)
2018,10,26,117996,78637,68352,10285,15,2018/10/26(10:00)
2018,10,25,117996,80187,68029,12158,17.9,2018/10/25(19:00)
2018,10,24,117996,80567,67241,13326,19.8,2018/10/24(19:00)
2018,10,23,117996,79919,68261,11658,17.1,2018/10/23(19:00)
2018,10,22,117996,80080,67942,12138,17.9,2018/10/22(19:00)
2018,10,21,117996,78562,57268,21294,37.2,2018/10/21(20:00)
2018,10,20,117996,77857,58460,19397,33.2,2018/10/20(19:00)
2018,10,19,117996,81181,66699,14482,21.7,2018/10/19(19:00)
2018,10,18,117996,81609,68273,13336,19.5,2018/10/18(19:00)
2018,10,17,117996,81346,67428,13918,20.6,2018/10/17(19:00)
2018,10,16,117996,80683,68140,12543,18.4,2018/10/16(19:00)
2018,10,15,117996,82338,67919,14419,21.2,2018/10/15(01:00)
2018,10,14,117996,80738,57197,23541,41.2,2018/10/14(20:00)
2018,10,13,117996,79514,58171,21343,36.7,2018/10/13(20:00)
2018,10,12,117996,83471,66908,16563,24.8,2018/10/12(19:00)
2018,10,11,117996,82365,67931,14434,21.2,2018/10/11(19:00)
2018,10,10,117996,80746,67212,13534,20.1,2018/10/10(19:00)
2018,10,09,117996,81359,63339,18020,28.5,2018/10/09(20:00)
2018,10,08,117996,82849,66445,16404,24.7,2018/10/08(19:00)
2018,10,07,117996,80216,56947,23269,40.9,2018/10/07(20:00)
2018,10,06,117996,80345,60380,19965,33.1,2018/10/06(11:00)
2018,10,05,117996,83732,68545,15187,22.2,2018/10/05(17:00)
2018,10,04,117996,83069,68210,14859,21.8,2018/10/04(19:00)
2018,10,03,117996,82997,63204,19793,31.3,2018/10/03(20:00)
2018,10,02,117996,83866,66291,17575,26.5,2018/10/02(19:00)
2018,10,01,117996,84255,66789,17466,26.2,2018/10/01(19:00)
2018,09,30,117996,85610,57311,28299,49.4,2018/09/30(20:00)
2018,09,29,117996,85117,59632,25485,42.7,2018/09/29(20:00)
2018,09,28,117996,87832,66524,21308,32,2018/09/28(17:00)
2018,09,27,117996,88882,65404,23478,35.9,2018/09/27(19:00)
2018,09,26,117996,87542,55992,31550,56.3,2018/09/26(20:00)
2018,09,25,117996,87802,51414,36388,70.8,2018/09/25(20:00)
2018,09,24,117996,87986,47981,40005,83.4,2018/09/24(20:00)
2018,09,23,117996,88136,51604,36532,70.8,2018/09/23(20:00)
2018,09,22,117996,89729,57029,32700,57.3,2018/09/22(20:00)
2018,09,21,117996,95074,69729,25345,36.3,2018/09/21(11:00)
2018,09,20,117996,93862,71784,22078,30.8,2018/09/20(15:00)
2018,09,19,117996,92949,72654,20295,27.9,2018/09/19(15:00)
2018,09,18,117996,92418,72897,19521,26.8,2018/09/18(17:00)
2018,09,17,117996,92041,73080,18961,25.9,2018/09/17(17:00)
2018,09,16,117996,84610,61788,22822,36.9,2018/09/16(20:00)
2018,09,15,117996,87380,64896,22484,34.6,2018/09/15(12:00)
2018,09,14,117996,92337,73530,18807,25.6,2018/09/14(15:00)
2018,09,13,117996,92278,73607,18671,25.4,2018/09/13(17:00)
2018,09,12,117996,92726,73004,19722,27,2018/09/12(17:00)
2018,09,11,117996,92845,71320,21525,30.2,2018/09/11(17:00)
2018,09,10,117996,91723,72230,19493,27,2018/09/10(17:00)
2018,09,09,117996,88849,59747,29102,48.7,2018/09/09(20:00)
2018,09,08,117996,86196,61542,24654,40.1,2018/09/08(20:00)
2018,09,07,117996,94835,73304,21531,29.4,2018/09/07(15:00)
2018,09,06,117996,94775,76604,18171,23.7,2018/09/06(15:00)
2018,09,05,117996,94830,75416,19414,25.7,2018/09/05(17:00)
2018,09,04,117996,94239,76268,17971,23.6,2018/09/04(17:00)
2018,09,03,117996,94223,78405,15818,20.2,2018/09/03(17:00)
2018,09,02,117996,91846,62574,29272,46.8,2018/09/02(20:00)
2018,09,01,117996,92587,65117,27470,42.2,2018/09/01(15:00)
2018,08,31,117996,97053,77420,19633,25.4,2018/08/31(11:00)
2018,08,30,117996,97129,81281,15848,19.5,2018/08/30(17:00)
2018,08,29,117840,97798,80284,17514,21.8,2018/08/29(17:00)
2018,08,28,117840,98287,79359,18928,23.9,2018/08/28(17:00)
2018,08,27,117840,98259,77224,21035,27.2,2018/08/27(17:00)
2018,08,26,117840,89602,61434,28168,45.9,2018/08/26(20:00)
2018,08,25,117840,91111,68483,22628,33,2018/08/25(14:00)
2018,08,24,117840,98764,79844,18920,23.7,2018/08/24(12:00)
2018,08,23,117840,98679,84786,13893,16.4,2018/08/23(15:00)
2018,08,22,117840,97791,87911,9880,11.2,2018/08/22(17:00)
2018,08,21,117840,98147,84025,14122,16.8,2018/08/21(17:00)
2018,08,20,117840,99274,83917,15357,18.3,2018/08/20(17:00)
2018,08,19,117840,93003,66730,26273,39.4,2018/08/19(20:00)
2018,08,18,117840,93030,67131,25899,38.6,2018/08/18(17:00)
2018,08,17,117840,99458,80289,19169,23.9,2018/08/17(17:00)
2018,08,16,117840,99943,88720,11223,12.6,2018/08/16(15:00)
2018,08,15,117840,98106,83275,14831,17.8,2018/08/15(15:00)
2018,08,14,117840,100250,91548,8702,9.5,2018/08/14(17:00)
2018,08,13,117840,100194,91405,8789,9.6,2018/08/13(17:00)
2018,08,12,117840,90835,73509,17326,23.6,2018/08/12(20:00)
2018,08,11,117840,90671,75167,15504,20.6,2018/08/11(15:00)
2018,08,10,117840,100189,87807,12382,14.1,2018/08/10(17:00)
2018,08,09,117840,99902,88582,11320,12.8,2018/08/09(17:00)
2018,08,08,117840,99829,88955,10874,12.2,2018/08/08(17:00)
2018,08,07,117840,99399,88873,10526,11.8,2018/08/07(17:00)
2018,08,06,117840,99237,88816,10421,11.7,2018/08/06(17:00)
2018,08,05,117840,95002,74791,20211,27,2018/08/05(21:00)
2018,08,04,117840,95423,74087,21336,28.8,2018/08/04(20:00)
2018,08,03,117840,99023,81589,17434,21.4,2018/08/03(17:00)
2018,08,02,117840,97975,82283,15692,19.1,2018/08/02(18:00)
2018,08,01,117840,96321,82486,13835,16.8,2018/08/01(18:00)
2018,07,31,117477,96087,83087,13000,15.6,2018/07/31(17:00)
2018,07,30,117477,96016,82882,13134,15.8,2018/07/30(17:00)
2018,07,29,117477,92104,72063,20041,27.8,2018/07/29(20:00)
2018,07,28,117477,92232,77487,14745,19,2018/07/28(12:00)
2018,07,27,117205,99117,90678,8439,9.3,2018/07/27(17:00)
2018,07,26,117205,99309,90682,8627,9.5,2018/07/26(17:00)
2018,07,25,117205,99296,90399,8897,9.8,2018/07/25(17:00)
2018,07,24,117205,99570,92478,7092,7.7,2018/07/24(17:00)
2018,07,23,117205,98296,90695,7601,8.4,2018/07/23(17:00)
2018,07,22,117205,97241,73794,23447,31.8,2018/07/22(21:00)
2018,07,21,117205,95628,76999,18629,24.2,2018/07/21(15:00)
2018,07,20,117205,97502,88080,9422,10.7,2018/07/20(17:00)
2018,07,19,117205,97937,87591,10346,11.8,2018/07/19(17:00)
2018,07,18,117205,97759,86710,11049,12.7,2018/07/18(17:00)
2018,07,17,117205,97112,86286,10826,12.5,2018/07/17(17:00)
2018,07,16,117205,95758,86306,9452,11,2018/07/16(17:00)
2018,07,15,117205,93127,69798,23329,33.4,2018/07/15(21:00)
2018,07,14,117205,92605,70700,21905,31,2018/07/14(15:00)
2018,07,13,117205,95558,82076,13482,16.4,2018/07/13(17:00)
2018,07,12,117205,96809,81393,15416,18.9,2018/07/12(17:00)
2018,07,11,117205,96148,79406,16742,21.1,2018/07/11(15:00)
2018,07,10,117205,95595,76258,19337,25.4,2018/07/10(17:00)
2018,07,09,117205,95045,70920,24125,34,2018/07/09(15:00)
2018,07,08,117205,90879,58944,31935,54.2,2018/07/08(21:00)
2018,07,07,117205,89827,60855,28972,47.6,2018/07/07(16:00)
2018,07,06,117205,91535,73639,17896,24.3,2018/07/06(15:00)
2018,07,05,117205,91119,77530,13589,17.5,2018/07/05(15:00)
2018,07,04,117205,89359,78919,10440,13.2,2018/07/04(17:00)
2018,07,03,117205,89020,77312,11708,15.1,2018/07/03(15:00)
2018,07,02,117205,89068,75611,13457,17.8,2018/07/02(15:00)
2018,07,01,117205,87679,60609,27070,44.7,2018/07/01(21:00)
2018,06,30,117205,88076,65571,22505,34.3,2018/06/30(14:00)
2018,06,29,117111,89332,75049,14283,19,2018/06/29(17:00)
2018,06,28,117111,88067,74820,13247,17.7,2018/06/28(15:00)
2018,06,27,117111,87793,74803,12990,17.4,2018/06/27(17:00)
2018,06,26,117111,89067,75237,13830,18.4,2018/06/26(17:00)
2018,06,25,117111,87256,76606,10650,13.9,2018/06/25(17:00)
2018,06,24,117111,84269,60899,23370,38.4,2018/06/24(21:00)
2018,06,23,117111,83862,61832,22030,35.6,2018/06/23(15:00)
2018,06,22,117111,86209,73832,12377,16.8,2018/06/22(17:00)
2018,06,21,117790,86791,72656,14135,19.5,2018/06/21(17:00)
2018,06,20,117790,85079,72551,12528,17.3,2018/06/20(17:00)
2018,06,19,117790,84861,72215,12646,17.5,2018/06/19(15:00)
2018,06,18,117790,84329,73210,11119,15.2,2018/06/18(17:00)
2018,06,17,117790,83729,58275,25454,43.7,2018/06/17(21:00)
2018,06,16,117790,83170,58833,24337,41.4,2018/06/16(21:00)
2018,06,15,117790,85115,68421,16694,24.4,2018/06/15(17:00)
2018,06,14,117790,85370,68133,17237,25.3,2018/06/14(17:00)
2018,06,13,117790,85139,65009,20130,31,2018/06/13(15:00)
2018,06,12,117790,84032,68930,15102,21.9,2018/06/12(17:00)
2018,06,11,117790,84435,68243,16192,23.7,2018/06/11(17:00)
2018,06,10,117790,83297,56753,26544,46.8,2018/06/10(21:00)
2018,06,09,117790,82730,61116,21614,35.4,2018/06/09(15:00)
2018,06,08,117790,83419,71187,12232,17.2,2018/06/08(17:00)
2018,06,07,117790,82558,73379,9179,12.5,2018/06/07(17:00)
2018,06,06,117790,82133,65117,17016,26.1,2018/06/06(17:00)
2018,06,05,117790,82500,71221,11279,15.8,2018/06/05(17:00)
2018,06,04,117790,81586,71429,10157,14.2,2018/06/04(17:00)
2018,06,03,117790,79806,58359,21447,36.8,2018/06/03(21:00)
2018,06,02,117790,80601,59990,20611,34.4,2018/06/02(15:00)
2018,06,01,117790,83704,70127,13577,19.4,2018/06/01(17:00)
2018,05,31,117790,84738,69024,15714,22.8,2018/05/31(17:00)
2018,05,30,117589,83449,70407,13042,18.5,2018/05/30(15:00)
2018,05,29,117589,81615,70664,10951,15.5,2018/05/29(17:00)
2018,05,28,117589,80264,70232,10032,14.3,2018/05/28(17:00)
2018,05,27,117589,78783,56576,22207,39.3,2018/05/27(21:00)
2018,05,26,117589,76661,58811,17850,30.4,2018/05/26(21:00)
2018,05,25,117589,80698,67071,13627,20.3,2018/05/25(15:00)
2018,05,24,117589,79966,66977,12989,19.4,2018/05/24(17:00)
2018,05,23,117589,80982,65409,15573,23.8,2018/05/23(17:00)
2018,05,22,117589,81093,60900,20193,33.2,2018/05/22(17:00)
2018,05,21,117589,80612,64307,16305,25.4,2018/05/21(17:00)
2018,05,20,117589,78999,55326,23673,42.8,2018/05/20(21:00)
2018,05,19,117589,79015,57867,21148,36.5,2018/05/19(11:00)
2018,05,18,117589,81942,70160,11782,16.8,2018/05/18(11:00)
2018,05,17,117589,82000,73173,8827,12.1,2018/05/17(15:00)
2018,05,16,117589,82967,72229,10738,14.9,2018/05/16(15:00)
2018,05,15,117589,80592,70067,10525,15,2018/05/15(17:00)
2018,05,14,117589,79618,66805,12813,19.2,2018/05/14(17:00)
2018,05,13,117589,76940,55959,20981,37.5,2018/05/13(21:00)
2018,05,12,117589,75171,60553,14618,24.1,2018/05/12(11:00)
2018,05,11,117589,79009,65425,13584,20.8,2018/05/11(17:00)
2018,05,10,117589,79074,65752,13322,20.3,2018/05/10(17:00)
2018,05,09,117589,79444,65350,14094,21.6,2018/05/09(17:00)
2018,05,08,117589,79415,65600,13815,21.1,2018/05/08(17:00)
2018,05,07,117589,80891,60354,20537,34,2018/05/07(21:00)
2018,05,06,117589,80610,55321,25289,45.7,2018/05/06(21:00)
2018,05,05,117589,79174,56278,22896,40.7,2018/05/05(01:00)
2018,05,04,117589,81094,63828,17266,27.1,2018/05/04(17:00)
2018,05,03,116747,80297,65747,14550,22.1,2018/05/03(20:00)
2018,05,02,116747,81261,67840,13421,19.8,2018/05/02(15:00)
2018,05,01,116747,81580,60435,21145,35,2018/05/01(20:00)
2018,04,30,116747,80785,64781,16004,24.7,2018/04/30(17:00)
2018,04,29,116747,77172,55893,21279,38.1,2018/04/29(21:00)
2018,04,28,116747,78144,56946,21198,37.2,2018/04/28(21:00)
2018,04,27,116747,79175,64547,14628,22.7,2018/04/27(17:00)
2018,04,26,116747,78154,65403,12751,19.5,2018/04/26(20:00)
2018,04,25,116747,76747,64939,11808,18.2,2018/04/25(20:00)
2018,04,24,116747,79133,68449,10684,15.6,2018/04/24(11:00)
2018,04,23,116747,79894,69692,10202,14.6,2018/04/23(11:00)
2018,04,22,116747,77731,56420,21311,37.8,2018/04/22(20:00)
2018,04,21,116747,78552,57277,21275,37.1,2018/04/21(20:00)
2018,04,20,116747,78947,65575,13372,20.4,2018/04/20(17:00)
2018,04,19,116747,78924,66264,12660,19.1,2018/04/19(20:00)
2018,04,18,116747,78400,65506,12894,19.7,2018/04/18(20:00)
2018,04,17,116747,77568,66456,11112,16.7,2018/04/17(20:00)
2018,04,16,116747,79121,65800,13321,20.2,2018/04/16(20:00)
2018,04,15,116747,80067,56623,23444,41.4,2018/04/15(21:00)
2018,04,14,116747,81200,62481,18719,30,2018/04/14(11:00)
2018,04,13,116747,81726,66251,15475,23.4,2018/04/13(10:00)
2018,04,12,116747,81768,66438,15330,23.1,2018/04/12(20:00)
2018,04,11,116747,81614,65533,16081,24.5,2018/04/11(20:00)
2018,04,10,116747,82433,66523,15910,23.9,2018/04/10(20:00)
2018,04,09,116747,83521,68149,15372,22.6,2018/04/09(10:00)
2018,04,08,116747,82219,58110,24109,41.5,2018/04/08(20:00)
2018,04,07,116747,81063,60912,20151,33.1,2018/04/07(11:00)
2018,04,06,116747,83403,69296,14107,20.4,2018/04/06(10:00)
2018,04,05,116747,84634,70520,14114,20,2018/04/05(11:00)
2018,04,04,116747,85253,68281,16972,24.9,2018/04/04(11:00)
2018,04,03,116747,84946,66335,18611,28.1,2018/04/03(20:00)
2018,04,02,116747,83579,65846,17733,26.9,2018/04/02(20:00)
2018,04,01,116747,84193,56397,27796,49.3,2018/04/01(20:00)
2018,03,31,116747,85067,57558,27509,47.8,2018/03/31(01:00)
2018,03,30,116747,89166,65637,23529,35.8,2018/03/30(10:00)
2018,03,29,116747,87826,67110,20716,30.9,2018/03/29(10:00)
2018,03,28,116747,87816,66068,21748,32.9,2018/03/28(10:00)
2018,03,27,116747,88147,67622,20525,30.4,2018/03/27(10:00)
2018,03,26,116747,89715,69467,20248,29.1,2018/03/26(10:00)
2018,03,25,116747,86394,57513,28881,50.2,2018/03/25(23:00)
2018,03,24,116747,87003,61698,25305,41,2018/03/24(01:00)
2018,03,23,116747,89581,72231,17350,24,2018/03/23(10:00)
2018,03,22,116747,90196,73423,16773,22.8,2018/03/22(10:00)
2018,03,21,116747,90501,78017,12484,16,2018/03/21(11:00)
2018,03,20,116747,90937,72583,18354,25.3,2018/03/20(11:00)
2018,03,19,116747,90418,72795,17623,24.2,2018/03/19(11:00)
2018,03,18,116747,88083,58324,29759,51,2018/03/18(23:00)
2018,03,17,116747,87175,61946,25229,40.7,2018/03/17(01:00)
2018,03,16,116747,91314,72510,18804,25.9,2018/03/16(10:00)
2018,03,15,116747,90695,71174,19521,27.4,2018/03/15(11:00)
2018,03,14,116747,90597,68060,22537,33.1,2018/03/14(09:00)
2018,03,13,116747,90231,71017,19214,27.1,2018/03/13(10:00)
2018,03,12,116747,88956,73285,15671,21.4,2018/03/12(10:00)
2018,03,11,116747,85495,59781,25714,43,2018/03/11(24:00)
2018,03,10,116747,86257,64427,21830,33.9,2018/03/10(01:00)
2018,03,09,116747,90418,75922,14496,19.1,2018/03/09(10:00)
2018,03,08,116747,90761,78855,11906,15.1,2018/03/08(11:00)
2018,03,07,116747,90131,75974,14157,18.6,2018/03/07(10:00)
2018,03,06,116747,91932,74384,17548,23.6,2018/03/06(10:00)
2018,03,05,116428,91613,77198,14415,18.7,2018/03/05(11:00)
2018,03,04,116428,88452,58887,29565,50.2,2018/03/04(20:00)
2018,03,03,116428,90231,64571,25660,39.7,2018/03/03(01:00)
2018,03,02,116428,93668,76433,17235,22.5,2018/03/02(10:00)
2018,03,01,116428,93988,68728,25260,36.8,2018/03/01(20:00)
2018,02,28,116428,96527,78122,18405,23.6,2018/02/28(15:00)
2018,02,27,116428,96476,77133,19343,25.1,2018/02/27(10:00)
2018,02,26,116428,96486,76656,19830,25.9,2018/02/26(10:00)
2018,02,25,116428,94215,63005,31210,49.5,2018/02/25(24:00)
2018,02,24,116428,91253,66278,24975,37.7,2018/02/24(11:00)
2018,02,23,116428,97115,79069,18046,22.8,2018/02/23(10:00)
2018,02,22,116428,97291,79662,17629,22.1,2018/02/22(10:00)
2018,02,21,116428,97072,80128,16944,21.1,2018/02/21(10:00)
2018,02,20,116428,96945,79383,17562,22.1,2018/02/20(10:00)
2018,02,19,116428,97460,76438,21022,27.5,2018/02/19(11:00)
2018,02,18,116428,92300,61172,31128,50.9,2018/02/18(24:00)
2018,02,17,116428,91080,59867,31213,52.1,2018/02/17(24:00)
2018,02,16,116428,91926,57733,34193,59.2,2018/02/16(24:00)
2018,02,15,116428,96010,63182,32828,52,2018/02/15(01:00)
2018,02,14,116428,98260,77843,20417,26.2,2018/02/14(10:00)
2018,02,13,116428,99516,83809,15707,18.7,2018/02/13(10:00)
2018,02,12,116428,99856,86637,13219,15.3,2018/02/12(11:00)
2018,02,11,116428,96307,68538,27769,40.5,2018/02/11(24:00)
2018,02,10,116428,95524,71240,24284,34.1,2018/02/10(11:00)
2018,02,09,116428,100220,84660,15560,18.4,2018/02/09(10:00)
2018,02,08,116428,99882,87277,12605,14.4,2018/02/08(10:00)
2018,02,07,116428,101050,87513,13537,15.5,2018/02/07(11:00)
2018,02,06,116428,101148,88238,12910,14.6,2018/02/06(10:00)
2018,02,05,116428,100724,87623,13101,15,2018/02/05(11:00)
2018,02,04,116428,95710,69711,25999,37.3,2018/02/04(24:00)
2018,02,03,116428,96130,72685,23445,32.3,2018/02/03(11:00)
2018,02,02,116428,100029,84653,15376,18.2,2018/02/02(10:00)
2018,02,01,116428,100239,83904,16335,19.5,2018/02/01(10:00)
2018,01,31,116428,99706,85260,14446,16.9,2018/01/31(10:00)
2018,01,30,116428,99203,86754,12449,14.3,2018/01/30(10:00)
2018,01,29,116428,99605,86561,13044,15.1,2018/01/29(11:00)
2018,01,28,116428,95051,68496,26555,38.8,2018/01/28(01:00)
2018,01,27,116428,97365,74418,22947,30.8,2018/01/27(01:00)
2018,01,26,116428,99232,87063,12169,14,2018/01/26(11:00)
2018,01,25,116428,99147,87247,11900,13.6,2018/01/25(17:00)
2018,01,24,116428,98511,86277,12234,14.2,2018/01/24(17:00)
2018,01,23,116428,98318,85442,12876,15.1,2018/01/23(11:00)
2018,01,22,116428,97485,80609,16876,20.9,2018/01/22(11:00)
2018,01,21,116428,94866,63917,30949,48.4,2018/01/21(24:00)
2018,01,20,116428,92979,67813,25166,37.1,2018/01/20(11:00)
2018,01,19,116428,96839,79633,17206,21.6,2018/01/19(10:00)
2018,01,18,116428,96327,79748,16579,20.8,2018/01/18(10:00)
2018,01,17,116428,95696,80766,14930,18.5,2018/01/17(11:00)
2018,01,16,116428,96018,82564,13454,16.3,2018/01/16(11:00)
2018,01,15,116428,95204,80495,14709,18.3,2018/01/15(10:00)
2018,01,14,116428,94636,66286,28350,42.8,2018/01/14(01:00)
2018,01,13,116428,93735,72843,20892,28.7,2018/01/13(11:00)
2018,01,12,116428,98988,85497,13491,15.8,2018/01/12(11:00)
2018,01,11,116428,98986,85612,13374,15.6,2018/01/11(11:00)
2018,01,10,116428,99146,84978,14168,16.7,2018/01/10(11:00)
2018,01,09,116428,98786,84021,14765,17.6,2018/01/09(11:00)
2018,01,08,116428,98246,83012,15234,18.4,2018/01/08(11:00)
2018,01,07,116428,94608,64428,30180,46.8,2018/01/07(01:00)
2018,01,06,116428,94963,68502,26461,38.6,2018/01/06(11:00)
2018,01,05,116428,98798,82551,16247,19.7,2018/01/05(10:00)
2018,01,04,116428,98111,84027,14084,16.8,2018/01/04(11:00)
2018,01,03,116428,98830,81596,17234,21.1,2018/01/03(10:00)
2018,01,02,116428,98255,79331,18924,23.9,2018/01/02(11:00)
2018,01,01,116428,97398,62145,35253,56.7,2018/01/01(24:00)
2017,12,31,116908,96958,62446,34512,55.3,2017/12/31(24:00)
2017,12,30,116908,95536,64779,30757,47.5,2017/12/30(11:00)
2017,12,29,116908,97981,78857,19124,24.3,2017/12/29(10:00)
2017,12,28,116908,97955,83478,14477,17.3,2017/12/28(10:00)
2017,12,27,116657,98281,83589,14692,17.6,2017/12/27(10:00)
2017,12,26,116657,97780,81374,16406,20.2,2017/12/26(10:00)
2017,12,25,116657,96082,66498,29584,44.5,2017/12/25(19:00)
2017,12,24,116657,94461,63302,31159,49.2,2017/12/24(24:00)
2017,12,23,116657,93545,67211,26334,39.2,2017/12/23(11:00)
2017,12,22,116657,95844,81852,13992,17.1,2017/12/22(10:00)
2017,12,21,116657,94978,83450,11528,13.8,2017/12/21(10:00)
2017,12,20,116657,97205,83664,13541,16.2,2017/12/20(10:00)
2017,12,19,116657,97171,83873,13298,15.9,2017/12/19(10:00)
2017,12,18,116657,96581,84640,11941,14.1,2017/12/18(11:00)
2017,12,17,116657,95078,66825,28253,42.3,2017/12/17(19:00)
2017,12,16,116657,92603,70890,21713,30.6,2017/12/16(11:00)
2017,12,15,116657,96407,84115,12292,14.6,2017/12/15(10:00)
2017,12,14,116657,96778,84968,11810,13.9,2017/12/14(10:00)
2017,12,13,116657,97418,84012,13406,16,2017/12/13(10:00)
2017,12,12,116657,96095,85133,10962,12.9,2017/12/12(10:00)
2017,12,11,116657,95498,83927,11571,13.8,2017/12/11(18:00)
2017,12,10,116657,90784,64000,26784,41.9,2017/12/10(24:00)
2017,12,09,116657,88449,68767,19682,28.6,2017/12/09(11:00)
2017,12,08,116657,92551,81361,11190,13.8,2017/12/08(10:00)
2017,12,07,116657,91572,80127,11445,14.3,2017/12/07(11:00)
2017,12,06,116657,91812,80911,10901,13.5,2017/12/06(10:00)
2017,12,05,116657,91914,80788,11126,13.8,2017/12/05(10:00)
2017,12,04,116657,92064,79221,12843,16.2,2017/12/04(18:00)
2017,12,03,116278,91700,61218,30482,49.8,2017/12/03(19:00)
2017,12,02,116278,92906,66179,26727,40.4,2017/12/02(11:00)
2017,12,01,116278,92783,77668,15115,19.5,2017/12/01(10:00)
2017,11,30,116278,92483,77048,15435,20,2017/11/30(10:00)
2017,11,29,116278,93866,74378,19488,26.2,2017/11/29(10:00)
2017,11,28,116278,93583,76519,17064,22.3,2017/11/28(10:00)
2017,11,27,116278,92492,76318,16174,21.2,2017/11/27(10:00)
2017,11,26,116278,88497,61257,27240,44.5,2017/11/26(24:00)
2017,11,25,116278,86553,65980,20573,31.2,2017/11/25(11:00)
2017,11,24,116278,92807,77605,15202,19.6,2017/11/24(10:00)
2017,11,23,116278,92783,77003,15780,20.5,2017/11/23(11:00)
2017,11,22,115900,91187,77349,13838,17.9,2017/11/22(11:00)
2017,11,21,115900,90278,77327,12951,16.7,2017/11/21(10:00)
2017,11,20,115900,91442,76794,14648,19.1,2017/11/20(18:00)
2017,11,19,115900,90095,61715,28380,46,2017/11/19(19:00)
2017,11,18,115900,89274,64400,24874,38.6,2017/11/18(19:00)
2017,11,17,115900,92398,74345,18053,24.3,2017/11/17(11:00)
2017,11,16,115900,91217,72971,18246,25,2017/11/16(18:00)
2017,11,15,115900,89682,71978,17704,24.6,2017/11/15(18:00)
2017,11,14,115900,87731,70501,17230,24.4,2017/11/14(18:00)
2017,11,13,115900,87918,70689,17229,24.4,2017/11/13(11:00)
2017,11,12,115900,87050,57618,29432,51.1,2017/11/12(19:00)
2017,11,11,115900,85993,59621,26372,44.2,2017/11/11(19:00)
2017,11,10,115900,85972,68299,17673,25.9,2017/11/10(17:00)
2017,11,09,115900,88234,67500,20734,30.7,2017/11/09(19:00)
2017,11,08,115900,88117,66862,21255,31.8,2017/11/08(18:00)
2017,11,07,115900,87229,67851,19378,28.6,2017/11/07(19:00)
2017,11,06,115900,88088,68148,19940,29.3,2017/11/06(19:00)
2017,11,05,115900,85517,56809,28708,50.5,2017/11/05(19:00)
2017,11,04,115900,83556,58933,24623,41.8,2017/11/04(19:00)
2017,11,03,115900,85673,66731,18942,28.4,2017/11/03(17:00)
2017,11,02,115900,86093,67063,19030,28.4,2017/11/02(19:00)
2017,11,01,115900,85425,66262,19163,28.9,2017/11/01(17:00)
2017,10,31,115900,87081,67675,19406,28.7,2017/10/31(19:00)
2017,10,30,115900,87521,68265,19256,28.2,2017/10/30(19:00)
2017,10,29,115900,84929,56295,28634,50.9,2017/10/29(20:00)
2017,10,28,115900,83421,58510,24911,42.6,2017/10/28(19:00)
2017,10,27,115900,86125,66589,19536,29.3,2017/10/27(19:00)
2017,10,26,115900,85521,67751,17770,26.2,2017/10/26(19:00)
2017,10,25,115900,87495,67111,20384,30.4,2017/10/25(19:00)
2017,10,24,115900,86397,67971,18426,27.1,2017/10/24(19:00)
2017,10,23,115900,87936,67501,20435,30.3,2017/10/23(19:00)
2017,10,22,115900,88162,56047,32115,57.3,2017/10/22(20:00)
2017,10,21,115900,86319,58896,27423,46.6,2017/10/21(19:00)
2017,10,20,115900,87499,66981,20518,30.6,2017/10/20(19:00)
2017,10,19,115900,86417,68224,18193,26.7,2017/10/19(19:00)
2017,10,18,115900,86343,67701,18642,27.5,2017/10/18(17:00)
2017,10,17,115900,85546,68021,17525,25.8,2017/10/17(19:00)
2017,10,16,115900,84250,67783,16467,24.3,2017/10/16(19:00)
2017,10,15,115249,83035,56499,26536,47,2017/10/15(20:00)
2017,10,14,115249,85314,58848,26466,45,2017/10/14(19:00)
2017,10,13,115249,87471,66400,21071,31.7,2017/10/13(19:00)
2017,10,12,115249,89422,67158,22264,33.2,2017/10/12(19:00)
2017,10,11,115249,89078,68423,20655,30.2,2017/10/11(11:00)
2017,10,10,115249,88736,70113,18623,26.6,2017/10/10(17:00)
2017,10,09,115249,88352,62781,25571,40.7,2017/10/09(19:00)
2017,10,08,115249,84897,56165,28732,51.2,2017/10/08(20:00)
2017,10,07,115249,84897,54716,30181,55.2,2017/10/07(20:00)
2017,10,06,115249,85300,52312,32988,63.1,2017/10/06(20:00)
2017,10,05,115249,86206,48919,37287,76.2,2017/10/05(20:00)
2017,10,04,115249,90044,46004,44040,95.7,2017/10/04(20:00)
2017,10,03,115249,89682,48934,40748,83.3,2017/10/03(20:00)
2017,10,02,115249,90276,55447,34829,62.8,2017/10/02(20:00)
2017,10,01,115249,89766,56530,33236,58.8,2017/10/01(20:00)
2017,09,30,115249,90193,58351,31842,54.6,2017/09/30(19:00)
2017,09,29,115249,93193,64707,28486,44,2017/09/29(18:00)
2017,09,28,114206,91397,68330,23067,33.8,2017/09/28(17:00)
2017,09,27,114206,90947,70978,19969,28.1,2017/09/27(15:00)
2017,09,26,114206,92144,72947,19197,26.3,2017/09/26(17:00)
2017,09,25,114206,91820,72798,19022,26.1,2017/09/25(17:00)
2017,09,24,114206,89652,59195,30457,51.5,2017/09/24(20:00)
2017,09,23,114206,89309,61791,27518,44.5,2017/09/23(15:00)
2017,09,22,114206,91816,69987,21829,31.2,2017/09/22(17:00)
2017,09,21,114206,91777,69362,22415,32.3,2017/09/21(17:00)
2017,09,20,114206,92456,68979,23477,34,2017/09/20(17:00)
2017,09,19,114206,92665,73115,19550,26.7,2017/09/19(16:00)
2017,09,18,114206,92551,71299,21252,29.8,2017/09/18(17:00)
2017,09,17,114206,87659,58088,29571,50.9,2017/09/17(20:00)
2017,09,16,114206,88214,60602,27612,45.6,2017/09/16(15:00)
2017,09,15,114206,92279,69521,22758,32.7,2017/09/15(17:00)
2017,09,14,114206,94191,71099,23092,32.5,2017/09/14(17:00)
2017,09,13,114206,93014,70373,22641,32.2,2017/09/13(17:00)
2017,09,12,114206,92313,72229,20084,27.8,2017/09/12(17:00)
2017,09,11,114206,92651,70946,21705,30.6,2017/09/11(15:00)
2017,09,10,114206,88745,59509,29236,49.1,2017/09/10(20:00)
2017,09,09,114206,89779,64087,25692,40.1,2017/09/09(15:00)
2017,09,08,114206,93909,73038,20871,28.6,2017/09/08(17:00)
2017,09,07,114206,94511,71699,22812,31.8,2017/09/07(17:00)
2017,09,06,114206,95006,71880,23126,32.2,2017/09/06(15:00)
2017,09,05,114206,94499,71944,22555,31.4,2017/09/05(15:00)
2017,09,04,114206,92846,72688,20158,27.7,2017/09/04(15:00)
2017,09,03,114206,91678,58814,32864,55.9,2017/09/03(20:00)
2017,09,02,114206,91533,61591,29942,48.6,2017/09/02(15:00)
2017,09,01,114206,94100,70931,23169,32.7,2017/09/01(17:00)
2017,08,31,114206,95847,70229,25618,36.5,2017/08/31(17:00)
2017,08,30,114206,96569,68797,27772,40.4,2017/08/30(16:00)
2017,08,29,114206,96582,71234,25348,35.6,2017/08/29(17:00)
2017,08,28,114206,95752,75454,20298,26.9,2017/08/28(15:00)
2017,08,27,114206,91074,59950,31124,51.9,2017/08/27(20:00)
2017,08,26,114206,91577,63547,28030,44.1,2017/08/26(15:00)
2017,08,25,114206,94808,79071,15737,19.9,2017/08/25(15:00)
2017,08,24,114206,95345,83432,11913,14.3,2017/08/24(15:00)
2017,08,23,114206,94851,83840,11011,13.1,2017/08/23(15:00)
2017,08,22,114206,94813,80879,13934,17.2,2017/08/22(17:00)
2017,08,21,114206,94942,79104,15838,20,2017/08/21(15:00)
2017,08,20,114206,91390,62497,28893,46.2,2017/08/20(20:00)
2017,08,19,114206,93359,67973,25386,37.3,2017/08/19(15:00)
2017,08,18,114206,95321,77648,17673,22.8,2017/08/18(17:00)
2017,08,17,114206,95799,77288,18511,24,2017/08/17(17:00)
2017,08,16,114206,95468,75902,19566,25.8,2017/08/16(15:00)
2017,08,15,114206,93361,67072,26289,39.2,2017/08/15(15:00)
2017,08,14,114206,94832,72855,21977,30.2,2017/08/14(15:00)
2017,08,13,114206,90404,61500,28904,47,2017/08/13(20:00)
2017,08,12,114206,91506,69570,21936,31.5,2017/08/12(15:00)
2017,08,11,113351,95564,80629,14935,18.5,2017/08/11(15:00)
2017,08,10,113351,94592,79807,14785,18.5,2017/08/10(17:00)
2017,08,09,113351,93714,80418,13296,16.5,2017/08/09(15:00)
2017,08,08,113351,94804,83775,11029,13.2,2017/08/08(15:00)
2017,08,07,113351,95125,84489,10636,12.6,2017/08/07(15:00)
2017,08,06,113351,88398,70906,17492,24.7,2017/08/06(21:00)
2017,08,05,113351,88265,72300,15965,22.1,2017/08/05(15:00)
2017,08,04,113351,91769,76990,14779,19.2,2017/08/04(17:00)
2017,08,03,113351,93031,74343,18688,25.1,2017/08/03(17:00)
2017,08,02,113351,93550,73103,20447,28,2017/08/02(17:00)
2017,08,01,113351,93092,71974,21118,29.3,2017/08/01(17:00)
2017,07,31,113351,93121,69467,23654,34.1,2017/07/31(15:00)
2017,07,30,113351,91077,63971,27106,42.4,2017/07/30(21:00)
2017,07,29,113351,90645,66214,24431,36.9,2017/07/29(12:00)
2017,07,28,113351,95482,78700,16782,21.3,2017/07/28(15:00)
2017,07,27,113351,95140,79180,15960,20.2,2017/07/27(17:00)
2017,07,26,113351,95163,80610,14553,18.1,2017/07/26(17:00)
2017,07,25,113351,94780,83321,11459,13.8,2017/07/25(15:00)
2017,07,24,113351,94461,82052,12409,15.1,2017/07/24(12:00)
2017,07,23,113351,89993,68319,21674,31.7,2017/07/23(21:00)
2017,07,22,113351,90733,75408,15325,20.3,2017/07/22(15:00)
2017,07,21,113351,94987,84586,10401,12.3,2017/07/21(17:00)
2017,07,20,113351,94712,84558,10154,12,2017/07/20(15:00)
2017,07,19,113351,94157,82682,11475,13.9,2017/07/19(17:00)
2017,07,18,113351,94706,80451,14255,17.7,2017/07/18(17:00)
2017,07,17,113305,93900,81042,12858,15.9,2017/07/17(15:00)
2017,07,16,113305,89317,65320,23997,36.7,2017/07/16(21:00)
2017,07,15,113305,89847,69532,20315,29.2,2017/07/15(12:00)
2017,07,14,113305,93437,83214,10223,12.3,2017/07/14(15:00)
2017,07,13,113305,92621,81830,10791,13.2,2017/07/13(17:00)
2017,07,12,113305,91477,80087,11390,14.2,2017/07/12(15:00)
2017,07,11,113305,92247,79685,12562,15.8,2017/07/11(15:00)
2017,07,10,113305,92732,78441,14291,18.2,2017/07/10(15:00)
2017,07,09,113305,88021,64400,23621,36.7,2017/07/09(21:00)
2017,07,08,113305,89545,68187,21358,31.3,2017/07/08(12:00)
2017,07,07,113305,93549,78640,14909,19,2017/07/07(15:00)
2017,07,06,113305,91939,80673,11266,14,2017/07/06(15:00)
2017,07,05,113305,89667,78494,11173,14.2,2017/07/05(15:00)
2017,07,04,113305,91290,78325,12965,16.6,2017/07/04(15:00)
2017,07,03,113305,92113,77051,15062,19.5,2017/07/03(15:00)
2017,07,02,113305,87819,61902,25917,41.9,2017/07/02(21:00)
2017,07,01,113305,86424,64637,21787,33.7,2017/07/01(15:00)
2017,06,30,113705,87888,75413,12475,16.5,2017/06/30(15:00)
2017,06,29,113705,87585,74958,12627,16.8,2017/06/29(15:00)
2017,06,28,113705,87698,74442,13256,17.8,2017/06/28(15:00)
2017,06,27,113705,87531,73199,14332,19.6,2017/06/27(15:00)
2017,06,26,113705,87820,73186,14634,20,2017/06/26(15:00)
2017,06,25,113705,85323,58182,27141,46.6,2017/06/25(21:00)
2017,06,24,113705,83428,63296,20132,31.8,2017/06/24(15:00)
2017,06,23,112779,86724,75077,11647,15.5,2017/06/23(15:00)
2017,06,22,112779,86466,73196,13270,18.1,2017/06/22(17:00)
2017,06,21,112779,86441,73408,13033,17.8,2017/06/21(15:00)
2017,06,20,111729,85132,73961,11171,15.1,2017/06/20(15:00)
2017,06,19,111729,85006,72473,12533,17.3,2017/06/19(17:00)
2017,06,18,112316,81885,57785,24100,41.7,2017/06/18(21:00)
2017,06,17,112316,83591,61261,22330,36.5,2017/06/17(15:00)
2017,06,16,112316,86941,71332,15609,21.9,2017/06/16(17:00)
2017,06,15,112316,84747,70246,14501,20.6,2017/06/15(17:00)
2017,06,14,112316,85205,68179,17026,25,2017/06/14(17:00)
2017,06,13,112316,84907,68006,16901,24.9,2017/06/13(15:00)
2017,06,12,111292,83421,66895,16526,24.7,2017/06/12(15:00)
2017,06,11,111292,83161,55233,27928,50.6,2017/06/11(21:00)
2017,06,10,111292,82165,58759,23406,39.8,2017/06/10(15:00)
2017,06,09,111292,83707,67241,16466,24.5,2017/06/09(16:00)
2017,06,08,111292,81647,66753,14894,22.3,2017/06/08(17:00)
2017,06,07,111292,82683,67008,15675,23.4,2017/06/07(15:00)
2017,06,06,111292,81083,61087,19996,32.7,2017/06/06(15:00)
2017,06,05,111292,81483,65530,15953,24.3,2017/06/05(17:00)
2017,06,04,111292,77623,54654,22969,42,2017/06/04(21:00)
2017,06,03,111292,76968,56898,20070,35.3,2017/06/03(15:00)
2017,06,02,111292,82221,65633,16588,25.3,2017/06/02(17:00)
2017,06,01,111292,81837,68853,12984,18.9,2017/06/01(15:00)
2017,05,31,111292,81665,69234,12431,18,2017/05/31(15:00)
2017,05,30,111292,82497,69887,12610,18,2017/05/30(15:00)
2017,05,29,111292,83014,69854,13160,18.8,2017/05/29(17:00)
2017,05,28,111292,82527,55277,27250,49.3,2017/05/28(21:00)
2017,05,27,111292,81212,56633,24579,43.4,2017/05/27(11:00)
2017,05,26,111292,83009,64402,18607,28.9,2017/05/26(17:00)
2017,05,25,111292,81835,67007,14828,22.1,2017/05/25(17:00)
2017,05,24,111292,83178,67810,15368,22.7,2017/05/24(15:00)
2017,05,23,111292,82751,67772,14979,22.1,2017/05/23(17:00)
2017,05,22,111292,81274,67482,13792,20.4,2017/05/22(17:00)
2017,05,21,111292,81065,55580,25485,45.9,2017/05/21(21:00)
2017,05,20,111292,80072,58028,22044,38,2017/05/20(15:00)
2017,05,19,111168,80693,66619,14074,21.1,2017/05/19(17:00)
2017,05,18,111168,80633,66176,14457,21.8,2017/05/18(17:00)
2017,05,17,111168,79301,65506,13795,21.1,2017/05/17(17:00)
2017,05,16,111168,80844,64434,16410,25.5,2017/05/16(17:00)
2017,05,15,111168,81620,64452,17168,26.6,2017/05/15(17:00)
2017,05,14,111168,77523,54246,23277,42.9,2017/05/14(21:00)
2017,05,13,111168,78407,57892,20515,35.4,2017/05/13(01:00)
2017,05,12,111168,80398,66500,13898,20.9,2017/05/12(11:00)
2017,05,11,111168,80138,65315,14823,22.7,2017/05/11(17:00)
2017,05,10,111168,80821,65137,15684,24.1,2017/05/10(11:00)
2017,05,09,111168,79013,61163,17850,29.2,2017/05/09(15:00)
2017,05,08,111168,77697,63803,13894,21.8,2017/05/08(17:00)
2017,05,07,111168,80272,53449,26823,50.2,2017/05/07(21:00)
2017,05,06,110671,79430,53271,26159,49.1,2017/05/06(21:00)
2017,05,05,110671,83028,56195,26833,47.7,2017/05/05(20:00)
2017,05,04,110671,83056,60366,22690,37.6,2017/05/04(17:00)
2017,05,03,110671,82942,58991,23951,40.6,2017/05/03(21:00)
2017,05,02,110671,82331,62100,20231,32.6,2017/05/02(17:00)
2017,05,01,110671,82501,56790,25711,45.3,2017/05/01(20:00)
2017,04,30,110671,80635,54163,26472,48.9,2017/04/30(21:00)
2017,04,29,110671,81130,55507,25623,46.2,2017/04/29(21:00)
2017,04,28,110671,80659,62861,17798,28.3,2017/04/28(17:00)
2017,04,27,110671,79714,63751,15963,25,2017/04/27(20:00)
2017,04,26,110671,80871,63329,17542,27.7,2017/04/26(11:00)
2017,04,25,110671,81209,64533,16676,25.8,2017/04/25(17:00)
2017,04,24,110671,82873,63820,19053,29.9,2017/04/24(20:00)
2017,04,23,110671,81850,54420,27430,50.4,2017/04/23(21:00)
2017,04,22,110671,83523,56424,27099,48,2017/04/22(21:00)
2017,04,21,110671,84048,63284,20764,32.8,2017/04/21(10:00)
2017,04,20,110671,83682,65335,18347,28.1,2017/04/20(15:00)
2017,04,19,110671,83051,62985,20066,31.9,2017/04/19(10:00)
2017,04,18,110671,83724,65101,18623,28.6,2017/04/18(17:00)
2017,04,17,110671,82855,66355,16500,24.9,2017/04/17(15:00)
2017,04,16,110671,82735,54282,28453,52.4,2017/04/16(21:00)
2017,04,15,110671,83099,55961,27138,48.5,2017/04/15(01:00)
2017,04,14,110502,85529,64493,21036,32.6,2017/04/14(17:00)
2017,04,13,110502,84544,64430,20114,31.2,2017/04/13(20:00)
2017,04,12,110502,85970,64262,21708,33.8,2017/04/12(20:00)
2017,04,11,110502,87343,65921,21422,32.5,2017/04/11(10:00)
2017,04,10,110502,87013,63993,23020,36,2017/04/10(20:00)
2017,04,09,110502,84126,54617,29509,54,2017/04/09(21:00)
2017,04,08,110502,86383,56759,29624,52.2,2017/04/08(10:00)
2017,04,07,110502,87253,65396,21857,33.4,2017/04/07(10:00)
2017,04,06,110502,87916,69129,18787,27.2,2017/04/06(11:00)
2017,04,05,110502,86046,68200,17846,26.2,2017/04/05(17:00)
2017,04,04,110502,86064,65973,20091,30.5,2017/04/04(10:00)
2017,04,03,110502,84021,65686,18335,27.9,2017/04/03(10:00)
2017,04,02,110502,85311,56420,28891,51.2,2017/04/02(23:00)
2017,04,01,110502,82935,59219,23716,40,2017/04/01(24:00)
2017,03,31,109493,88725,68976,19749,28.6,2017/03/31(10:00)
2017,03,30,109493,87994,67807,20187,29.8,2017/03/30(10:00)
2017,03,29,109493,87117,69891,17226,24.6,2017/03/29(10:00)
2017,03,28,109493,86241,70060,16181,23.1,2017/03/28(10:00)
2017,03,27,108601,88323,70135,18188,25.9,2017/03/27(10:00)
2017,03,26,108601,87877,57467,30410,52.9,2017/03/26(23:00)
2017,03,25,108601,86606,61395,25211,41.1,2017/03/25(11:00)
2017,03,24,108601,88072,69257,18815,27.2,2017/03/24(10:00)
2017,03,23,108601,87672,69549,18123,26.1,2017/03/23(10:00)
2017,03,22,108601,87657,70170,17487,24.9,2017/03/22(10:00)
2017,03,21,108601,87503,68210,19293,28.3,2017/03/21(20:00)
2017,03,20,108601,87922,69809,18113,25.9,2017/03/20(11:00)
2017,03,19,108601,87910,56890,31020,54.5,2017/03/19(23:00)
2017,03,18,108601,90013,61921,28092,45.4,2017/03/18(10:00)
2017,03,17,108601,91839,70322,21517,30.6,2017/03/17(10:00)
2017,03,16,107703,91482,70775,20707,29.3,2017/03/16(10:00)
2017,03,15,107703,90591,71134,19457,27.4,2017/03/15(10:00)
2017,03,14,107703,91119,70674,20445,28.9,2017/03/14(10:00)
2017,03,13,107703,93327,70385,22942,32.6,2017/03/13(10:00)
2017,03,12,107703,91063,57589,33474,58.1,2017/03/12(01:00)
2017,03,11,107703,90228,62468,27760,44.4,2017/03/11(01:00)
2017,03,10,107703,92047,73349,18698,25.5,2017/03/10(10:00)
2017,03,09,107703,92807,74556,18251,24.5,2017/03/09(10:00)
2017,03,08,107703,92902,76634,16268,21.2,2017/03/08(10:00)
2017,03,07,107098,93840,76756,17084,22.3,2017/03/07(10:00)
2017,03,06,107098,94148,73396,20752,28.3,2017/03/06(10:00)
2017,03,05,107098,91770,58780,32990,56.1,2017/03/05(24:00)
2017,03,04,107098,91420,62651,28769,45.9,2017/03/04(01:00)
2017,03,03,107098,93749,74262,19487,26.2,2017/03/03(10:00)
2017,03,02,107098,92979,75921,17058,22.5,2017/03/02(10:00)
2017,03,01,107098,92104,64523,27581,42.7,2017/03/01(20:00)
2017,02,28,107098,92437,73617,18820,25.6,2017/02/28(10:00)
2017,02,27,107098,93171,73564,19607,26.7,2017/02/27(10:00)
2017,02,26,107098,91375,60444,30931,51.2,2017/02/26(24:00)
2017,02,25,107098,91811,64596,27215,42.1,2017/02/25(01:00)
2017,02,24,107098,92732,75970,16762,22.1,2017/02/24(10:00)
2017,02,23,107098,93526,75909,17617,23.2,2017/02/23(10:00)
2017,02,22,107098,93689,78523,15166,19.3,2017/02/22(11:00)
2017,02,21,107098,93347,77149,16198,21,2017/02/21(10:00)
2017,02,20,107098,93928,76063,17865,23.5,2017/02/20(11:00)
2017,02,19,107098,89643,61553,28090,45.6,2017/02/19(01:00)
2017,02,18,107098,90042,65574,24468,37.3,2017/02/18(11:00)
2017,02,17,107098,96207,74358,21849,29.4,2017/02/17(10:00)
2017,02,16,107098,96295,75604,20691,27.4,2017/02/16(10:00)
2017,02,15,107098,96403,77770,18633,24,2017/02/15(10:00)
2017,02,14,107098,96561,78279,18282,23.4,2017/02/14(10:00)
2017,02,13,107098,96343,79050,17293,21.9,2017/02/13(11:00)
2017,02,12,107098,93782,64047,29735,46.4,2017/02/12(01:00)
2017,02,11,107098,92955,69363,23592,34,2017/02/11(11:00)
2017,02,10,107098,95916,81268,14648,18,2017/02/10(11:00)
2017,02,09,107098,97002,80002,17000,21.2,2017/02/09(10:00)
2017,02,08,107098,96980,79274,17706,22.3,2017/02/08(11:00)
2017,02,07,107098,97305,80163,17142,21.4,2017/02/07(10:00)
2017,02,06,107098,96366,78251,18115,23.1,2017/02/06(10:00)
2017,02,05,107098,94991,62577,32414,51.8,2017/02/05(24:00)
2017,02,04,107098,94172,67533,26639,39.4,2017/02/04(11:00)
2017,02,03,107098,96289,78232,18057,23.1,2017/02/03(10:00)
2017,02,02,107098,96341,80243,16098,20.1,2017/02/02(10:00)
2017,02,01,107098,95220,80173,15047,18.8,2017/02/01(11:00)
2017,01,31,106238,94937,77034,17903,23.2,2017/01/31(11:00)
2017,01,30,106238,91686,62634,29052,46.4,2017/01/30(24:00)
2017,01,29,106238,89100,57667,31433,54.5,2017/01/29(24:00)
2017,01,28,106238,89072,56442,32630,57.8,2017/01/28(01:00)
2017,01,27,106238,91078,62908,28170,44.8,2017/01/27(01:00)
2017,01,26,106238,95631,78670,16961,21.6,2017/01/26(10:00)
2017,01,25,106238,95823,81686,14137,17.3,2017/01/25(10:00)
2017,01,24,106238,96526,82884,13642,16.5,2017/01/24(10:00)
2017,01,23,106238,95443,83657,11786,14.1,2017/01/23(11:00)
2017,01,22,106238,91965,66749,25216,37.8,2017/01/22(24:00)
2017,01,21,106238,90927,71225,19702,27.7,2017/01/21(11:00)
2017,01,20,106238,94284,81765,12519,15.3,2017/01/20(11:00)
2017,01,19,106238,94146,80171,13975,17.4,2017/01/19(10:00)
2017,01,18,106238,95091,79959,15132,18.9,2017/01/18(10:00)
2017,01,17,105866,94280,81681,12599,15.4,2017/01/17(10:00)
2017,01,16,105866,93313,80790,12523,15.5,2017/01/16(11:00)
2017,01,15,105866,91004,66021,24983,37.8,2017/01/15(01:00)
2017,01,14,105866,92828,69894,22934,32.8,2017/01/14(11:00)
2017,01,13,105866,94912,80079,14833,18.5,2017/01/13(11:00)
2017,01,12,105866,94338,78403,15935,20.3,2017/01/12(10:00)
2017,01,11,105866,94862,78898,15964,20.2,2017/01/11(10:00)
2017,01,10,105866,93039,76690,16349,21.3,2017/01/10(10:00)
2017,01,09,105866,92252,75090,17162,22.9,2017/01/09(11:00)
2017,01,08,105866,90644,59058,31586,53.5,2017/01/08(24:00)
2017,01,07,105866,90470,64879,25591,39.4,2017/01/07(11:00)
2017,01,06,105866,92841,74060,18781,25.4,2017/01/06(10:00)
2017,01,05,105866,92474,76304,16170,21.2,2017/01/05(11:00)
2017,01,04,105866,92353,75778,16575,21.9,2017/01/04(10:00)
2017,01,03,105866,94223,75471,18752,24.8,2017/01/03(10:00)
2017,01,02,105866,92573,72901,19672,27,2017/01/02(11:00)
2017,01,01,105866,89861,59234,30627,51.7,2017/01/01(01:00)
2016,12,31,105866,92458,63693,28765,45.2,2016/12/31(01:00)
2016,12,30,105866,93773,76199,17574,23.1,2016/12/30(10:00)
2016,12,29,105866,93229,77900,15329,19.7,2016/12/29(10:00)
2016,12,28,105866,92564,77863,14701,18.9,2016/12/28(10:00)
2016,12,27,105866,92007,76864,15143,19.7,2016/12/27(10:00)
2016,12,26,105866,91610,77204,14406,18.7,2016/12/26(11:00)
2016,12,25,105866,88547,61186,27361,44.7,2016/12/25(01:00)
2016,12,24,105866,90172,66078,24094,36.5,2016/12/24(11:00)
2016,12,23,105866,90894,77048,13846,18,2016/12/23(11:00)
2016,12,22,105866,90449,73690,16759,22.7,2016/12/22(17:00)
2016,12,21,105866,89166,74306,14860,20,2016/12/21(10:00)
2016,12,20,104466,89662,74281,15381,20.7,2016/12/20(10:00)
2016,12,19,104466,91271,76506,14765,19.3,2016/12/19(11:00)
2016,12,18,104466,88826,61057,27769,45.5,2016/12/18(01:00)
2016,12,17,104466,89028,67116,21912,32.6,2016/12/17(11:00)
2016,12,16,104466,93031,79966,13065,16.3,2016/12/16(10:00)
2016,12,15,103299,92819,78945,13874,17.6,2016/12/15(10:00)
2016,12,14,103299,92681,77634,15047,19.4,2016/12/14(11:00)
2016,12,13,103299,92178,76461,15717,20.6,2016/12/13(10:00)
2016,12,12,103299,92578,77426,15152,19.6,2016/12/12(11:00)
2016,12,11,103299,87632,61800,25832,41.8,2016/12/11(24:00)
2016,12,10,103299,85209,65024,20185,31,2016/12/10(11:00)
2016,12,09,103299,91310,73993,17317,23.4,2016/12/09(10:00)
2016,12,08,103299,90628,76313,14315,18.8,2016/12/08(10:00)
2016,12,07,103299,90821,76917,13904,18.1,2016/12/07(10:00)
2016,12,06,103299,90426,74652,15774,21.1,2016/12/06(10:00)
2016,12,05,103299,87795,72596,15199,20.9,2016/12/05(10:00)
2016,12,04,103299,82341,58853,23488,39.9,2016/12/04(24:00)
2016,12,03,103299,83525,62882,20643,32.8,2016/12/03(11:00)
2016,12,02,103299,85671,73589,12082,16.4,2016/12/02(10:00)
2016,12,01,103299,86447,72598,13849,19.1,2016/12/01(18:00)
2016,11,30,103299,85024,74959,10065,13.4,2016/11/30(11:00)
2016,11,29,103299,85937,74156,11781,15.9,2016/11/29(10:00)
2016,11,28,103299,83432,73520,9912,13.5,2016/11/28(18:00)
2016,11,27,103299,75011,59455,15556,26.2,2016/11/27(24:00)
2016,11,26,103299,73620,66203,7417,11.2,2016/11/26(11:00)
2016,11,25,103299,82612,73611,9001,12.2,2016/11/25(10:00)
2016,11,24,103299,83190,74022,9168,12.4,2016/11/24(18:00)
2016,11,23,103299,83056,72066,10990,15.2,2016/11/23(10:00)
2016,11,22,103299,82141,71284,10857,15.2,2016/11/22(18:00)
2016,11,21,103299,80430,68476,11954,17.5,2016/11/21(11:00)
2016,11,20,103299,77873,55821,22052,39.5,2016/11/20(01:00)
2016,11,19,103299,77440,60212,17228,28.6,2016/11/19(11:00)
2016,11,18,103299,83566,67877,15689,23.1,2016/11/18(10:00)
2016,11,17,103299,84260,67768,16492,24.3,2016/11/17(10:00)
2016,11,16,103299,83901,68765,15136,22,2016/11/16(10:00)
2016,11,15,103299,81672,67832,13840,20.4,2016/11/15(19:00)
2016,11,14,103299,80581,66834,13747,20.6,2016/11/14(18:00)
2016,11,13,103299,76063,55217,20846,37.8,2016/11/13(19:00)
2016,11,12,103299,75429,58495,16934,28.9,2016/11/12(10:00)
2016,11,11,103299,81485,67352,14133,21,2016/11/11(10:00)
2016,11,10,103299,82444,69906,12538,17.9,2016/11/10(10:00)
2016,11,09,103299,81574,67885,13689,20.2,2016/11/09(10:00)
2016,11,08,103299,81278,68309,12969,19,2016/11/08(19:00)
2016,11,07,103299,80166,65572,14594,22.3,2016/11/07(18:00)
2016,11,06,103299,76791,55010,21781,39.6,2016/11/06(19:00)
2016,11,05,103299,74244,58041,16203,27.9,2016/11/05(11:00)
2016,11,04,103299,81469,67038,14431,21.5,2016/11/04(10:00)
2016,11,03,103299,81900,68016,13884,20.4,2016/11/03(11:00)
2016,11,02,103299,82339,68711,13628,19.8,2016/11/02(10:00)
2016,11,01,103068,83119,68949,14170,20.6,2016/11/01(19:00)
2016,10,31,103068,78563,68282,10281,15.1,2016/10/31(18:00)
2016,10,30,103068,68186,54656,13530,24.8,2016/10/30(20:00)
2016,10,29,103068,71412,58250,13162,22.6,2016/10/29(11:00)
2016,10,28,103068,78097,65408,12689,19.4,2016/10/28(11:00)
2016,10,27,103068,79533,65786,13747,20.9,2016/10/27(19:00)
2016,10,26,103068,80450,64893,15557,24,2016/10/26(19:00)
2016,10,25,103068,79305,66171,13134,19.8,2016/10/25(19:00)
2016,10,24,103068,78892,65420,13472,20.6,2016/10/24(19:00)
2016,10,23,103068,67737,54151,13586,25.1,2016/10/23(20:00)
2016,10,22,103068,68353,57118,11235,19.7,2016/10/22(11:00)
2016,10,21,103068,76471,64898,11573,17.8,2016/10/21(15:00)
2016,10,20,103068,77231,66271,10960,16.5,2016/10/20(19:00)
2016,10,19,103068,75887,65157,10730,16.5,2016/10/19(19:00)
2016,10,18,103068,76148,66241,9907,15,2016/10/18(19:00)
2016,10,17,103068,76480,65430,11050,16.9,2016/10/17(19:00)
2016,10,16,103068,66094,54441,11653,21.4,2016/10/16(19:00)
2016,10,15,103068,67045,56484,10561,18.7,2016/10/15(19:00)
2016,10,14,103068,76826,64400,12426,19.3,2016/10/14(19:00)
2016,10,13,103068,76509,65420,11089,17,2016/10/13(19:00)
2016,10,12,102018,75340,64249,11091,17.3,2016/10/12(19:00)
2016,10,11,102018,77312,65143,12169,18.7,2016/10/11(19:00)
2016,10,10,102018,77874,64320,13554,21.1,2016/10/10(19:00)
2016,10,09,102018,66322,53219,13103,24.6,2016/10/09(20:00)
2016,10,08,102018,67494,58538,8956,15.3,2016/10/08(01:00)
2016,10,07,102018,77361,66082,11279,17.1,2016/10/07(17:00)
2016,10,06,102018,77712,65864,11848,18,2016/10/06(17:00)
2016,10,05,102018,77328,66398,10930,16.5,2016/10/05(17:00)
2016,10,04,102018,77549,68076,9473,13.9,2016/10/04(17:00)
2016,10,03,102018,72367,59881,12486,20.9,2016/10/03(20:00)
2016,10,02,102018,69881,54396,15485,28.5,2016/10/02(20:00)
2016,10,01,102018,68617,57724,10893,18.9,2016/10/01(11:00)
2016,09,30,102018,81194,65346,15848,24.3,2016/09/30(15:00)
2016,09,29,101025,79489,66486,13003,19.6,2016/09/29(15:00)
2016,09,28,101025,80198,68539,11659,17,2016/09/28(15:00)
2016,09,27,101025,80158,69576,10582,15.2,2016/09/27(15:00)
2016,09,26,101025,80789,68737,12052,17.5,2016/09/26(17:00)
2016,09,25,101025,70298,55864,14434,25.8,2016/09/25(20:00)
2016,09,24,101025,70343,59413,10930,18.4,2016/09/24(15:00)
2016,09,23,101025,81421,67087,14334,21.4,2016/09/23(17:00)
2016,09,22,101025,81501,66526,14975,22.5,2016/09/22(17:00)
2016,09,21,101025,83811,65243,18568,28.5,2016/09/21(17:00)
2016,09,20,101025,84287,65571,18716,28.5,2016/09/20(17:00)
2016,09,19,101025,84281,66807,17474,26.2,2016/09/19(15:00)
2016,09,18,101025,72246,55063,17183,31.2,2016/09/18(20:00)
2016,09,17,101025,69461,52183,17278,33.1,2016/09/17(20:00)
2016,09,16,101025,70906,51254,19652,38.3,2016/09/16(20:00)
2016,09,15,101025,71121,48036,23085,48.1,2016/09/15(20:00)
2016,09,14,101025,71498,50931,20567,40.4,2016/09/14(01:00)
2016,09,13,101025,84097,67051,17046,25.4,2016/09/13(15:00)
2016,09,12,101025,87436,70245,17191,24.5,2016/09/12(15:00)
2016,09,11,101025,76541,59361,17180,28.9,2016/09/11(20:00)
2016,09,10,101025,75753,64267,11486,17.9,2016/09/10(15:00)
2016,09,09,101025,85078,72942,12136,16.6,2016/09/09(15:00)
2016,09,08,101025,85869,72779,13090,18,2016/09/08(15:00)
2016,09,07,101025,85422,74096,11326,15.3,2016/09/07(15:00)
2016,09,06,101025,85469,74763,10706,14.3,2016/09/06(15:00)
2016,09,05,101025,85109,75299,9810,13,2016/09/05(17:00)
2016,09,04,101025,73267,59979,13288,22.2,2016/09/04(20:00)
2016,09,03,101025,75346,62793,12553,20,2016/09/03(15:00)
2016,09,02,101025,88668,70674,17994,25.5,2016/09/02(15:00)
2016,09,01,101025,88838,72151,16687,23.1,2016/09/01(15:00)
2016,08,31,101025,90561,66093,24468,37,2016/08/31(17:00)
2016,08,30,100670,90930,66987,23943,35.7,2016/08/30(17:00)
2016,08,29,100670,91348,67384,23964,35.6,2016/08/29(17:00)
2016,08,28,100670,79409,55005,24404,44.4,2016/08/28(20:00)
2016,08,27,100670,80851,61325,19526,31.8,2016/08/27(15:00)
2016,08,26,100670,90970,71673,19297,26.9,2016/08/26(11:00)
2016,08,25,100670,90720,81780,8940,10.9,2016/08/25(15:00)
2016,08,24,100670,90720,81362,9358,11.5,2016/08/24(17:00)
2016,08,23,100670,90449,82564,7885,9.6,2016/08/23(15:00)
2016,08,22,100670,90425,83731,6694,8,2016/08/22(17:00)
2016,08,21,100180,79171,67470,11701,17.3,2016/08/21(20:00)
2016,08,20,100180,84910,72886,12024,16.5,2016/08/20(15:00)
2016,08,19,100180,91151,82770,8381,10.1,2016/08/19(15:00)
2016,08,18,100180,91084,83742,7342,8.8,2016/08/18(15:00)
2016,08,17,100180,91009,83296,7713,9.3,2016/08/17(15:00)
2016,08,16,100180,90967,83068,7899,9.5,2016/08/16(17:00)
2016,08,15,100180,83695,71947,11748,16.3,2016/08/15(15:00)
2016,08,14,100180,80544,67993,12551,18.5,2016/08/14(21:00)
2016,08,13,100180,83300,74429,8871,11.9,2016/08/13(15:00)
2016,08,12,100180,92395,85183,7212,8.5,2016/08/12(17:00)
2016,08,11,100180,91680,84974,6706,7.9,2016/08/11(17:00)
2016,08,10,100180,92386,83123,9263,11.1,2016/08/10(17:00)
2016,08,09,100180,91440,82724,8716,10.5,2016/08/09(15:00)
2016,08,08,100180,89608,83700,5908,7.1,2016/08/08(15:00)
2016,08,07,100180,76815,67510,9305,13.8,2016/08/07(21:00)
2016,08,06,100180,81236,71602,9634,13.5,2016/08/06(15:00)
2016,08,05,100180,88096,77573,10523,13.6,2016/08/05(15:00)
2016,08,04,100180,88410,75694,12716,16.8,2016/08/04(17:00)
2016,08,03,100180,88676,69613,19063,27.4,2016/08/03(15:00)
2016,08,02,100180,89826,68743,21083,30.7,2016/08/02(15:00)
2016,08,01,100180,89095,68944,20151,29.2,2016/08/01(15:00)
2016,07,31,100180,76193,64469,11724,18.2,2016/07/31(21:00)
2016,07,30,100180,77676,66669,11007,16.5,2016/07/30(15:00)
2016,07,29,100180,86712,76408,10304,13.5,2016/07/29(15:00)
2016,07,28,100180,89311,79547,9764,12.3,2016/07/28(15:00)
2016,07,27,100180,89712,80482,9230,11.5,2016/07/27(15:00)
2016,07,26,100180,88923,81110,7813,9.6,2016/07/26(15:00)
2016,07,25,100180,88990,80215,8775,10.9,2016/07/25(15:00)
2016,07,24,100180,76202,65790,10412,15.8,2016/07/24(21:00)
2016,07,23,100180,79141,69122,10019,14.5,2016/07/23(15:00)
2016,07,22,100180,88555,77815,10740,13.8,2016/07/22(17:00)
2016,07,21,100180,88526,76366,12160,15.9,2016/07/21(17:00)
2016,07,20,100180,88889,76667,12222,15.9,2016/07/20(15:00)
2016,07,19,100180,88635,75150,13485,17.9,2016/07/19(15:00)
2016,07,18,99878,89091,71810,17281,24.1,2016/07/18(17:00)
2016,07,17,99878,76339,57401,18938,33,2016/07/17(21:00)
2016,07,16,99878,78526,62859,15667,24.9,2016/07/16(12:00)
2016,07,15,99878,88032,74767,13265,17.7,2016/07/15(15:00)
2016,07,14,99878,87194,76203,10991,14.4,2016/07/14(15:00)
2016,07,13,99878,86944,76326,10618,13.9,2016/07/13(15:00)
2016,07,12,99878,86506,76630,9876,12.9,2016/07/12(15:00)
2016,07,11,99878,85481,78197,7284,9.3,2016/07/11(15:00)
2016,07,10,99878,73413,61203,12210,20,2016/07/10(21:00)
2016,07,09,99878,74830,66515,8315,12.5,2016/07/09(15:00)
2016,07,08,98948,84847,74997,9850,13.1,2016/07/08(15:00)
2016,07,07,98948,86068,73086,12982,17.8,2016/07/07(15:00)
2016,07,06,98948,86705,71949,14756,20.5,2016/07/06(15:00)
2016,07,05,98948,86753,72993,13760,18.9,2016/07/05(15:00)
2016,07,04,98948,85873,69487,16386,23.6,2016/07/04(15:00)
2016,07,03,98948,75199,56509,18690,33.1,2016/07/03(21:00)
2016,07,02,98948,75644,61952,13692,22.1,2016/07/02(12:00)
2016,07,01,98948,85533,72275,13258,18.3,2016/07/01(15:00)
2016,06,30,98948,83978,72528,11450,15.8,2016/06/30(15:00)
2016,06,29,98948,83457,71556,11901,16.6,2016/06/29(15:00)
2016,06,28,98948,83416,71431,11985,16.8,2016/06/28(15:00)
2016,06,27,98948,83934,70520,13414,19,2016/06/27(15:00)
2016,06,26,98948,71621,56370,15251,27.1,2016/06/26(21:00)
2016,06,25,98948,72876,59406,13470,22.7,2016/06/25(21:00)
2016,06,24,98948,82074,70325,11749,16.7,2016/06/24(15:00)
2016,06,23,98948,80956,72816,8140,11.2,2016/06/23(15:00)
2016,06,22,98948,81593,72340,9253,12.8,2016/06/22(15:00)
2016,06,21,98948,80966,72018,8948,12.4,2016/06/21(15:00)
2016,06,20,98948,80999,71333,9666,13.6,2016/06/20(15:00)
2016,06,19,98948,71404,57111,14293,25,2016/06/19(21:00)
2016,06,18,98948,70240,61326,8914,14.5,2016/06/18(15:00)
2016,06,17,98948,81941,69037,12904,18.7,2016/06/17(17:00)
2016,06,16,98948,81864,67964,13900,20.5,2016/06/16(15:00)
2016,06,15,98948,82117,68154,13963,20.5,2016/06/15(15:00)
2016,06,14,98948,80985,69628,11357,16.3,2016/06/14(15:00)
2016,06,13,98948,79589,69342,10247,14.8,2016/06/13(17:00)
2016,06,12,98948,70120,56360,13760,24.4,2016/06/12(21:00)
2016,06,11,98948,72076,61226,10850,17.7,2016/06/11(15:00)
2016,06,10,98948,79214,69908,9306,13.3,2016/06/10(15:00)
2016,06,09,98948,80280,68792,11488,16.7,2016/06/09(17:00)
2016,06,08,98948,80661,67384,13277,19.7,2016/06/08(15:00)
2016,06,07,98948,80807,66902,13905,20.8,2016/06/07(17:00)
2016,06,06,98948,72901,58231,14670,25.2,2016/06/06(15:00)
2016,06,05,98948,71323,54852,16471,30,2016/06/05(21:00)
2016,06,04,98948,71809,58332,13477,23.1,2016/06/04(12:00)
2016,06,03,98948,80650,67242,13408,19.9,2016/06/03(15:00)
2016,06,02,98948,80301,67243,13058,19.4,2016/06/02(17:00)
2016,06,01,98948,79870,66550,13320,20,2016/06/01(17:00)
2016,05,31,98948,80087,68011,12076,17.8,2016/05/31(15:00)
2016,05,30,98948,78211,67467,10744,15.9,2016/05/30(17:00)
2016,05,29,98948,71377,54762,16615,30.3,2016/05/29(21:00)
2016,05,28,98948,71910,58181,13729,23.6,2016/05/28(12:00)
2016,05,27,98948,77748,66831,10917,16.3,2016/05/27(15:00)
2016,05,26,98948,79616,66201,13415,20.3,2016/05/26(17:00)
2016,05,25,98948,78513,65014,13499,20.8,2016/05/25(17:00)
2016,05,24,98948,78445,65836,12609,19.2,2016/05/24(11:00)
2016,05,23,98948,78012,66919,11093,16.6,2016/05/23(17:00)
2016,05,22,98948,71452,54753,16699,30.5,2016/05/22(21:00)
2016,05,21,98948,72681,57439,15242,26.5,2016/05/21(21:00)
2016,05,20,98948,77682,66044,11638,17.6,2016/05/20(17:00)
2016,05,19,98948,77843,66331,11512,17.4,2016/05/19(17:00)
2016,05,18,98948,77528,64944,12584,19.4,2016/05/18(17:00)
2016,05,17,98948,77333,63763,13570,21.3,2016/05/17(17:00)
2016,05,16,98948,77734,62267,15467,24.8,2016/05/16(17:00)
2016,05,15,98948,73973,53811,20162,37.5,2016/05/15(21:00)
2016,05,14,98948,73290,55611,17679,31.8,2016/05/14(21:00)
2016,05,13,98948,79581,63059,16522,26.2,2016/05/13(17:00)
2016,05,12,98948,78180,63305,14875,23.5,2016/05/12(17:00)
2016,05,11,98948,78974,62605,16369,26.1,2016/05/11(17:00)
2016,05,10,98948,79134,64634,14500,22.4,2016/05/10(11:00)
2016,05,09,98948,77645,63579,14066,22.1,2016/05/09(17:00)
2016,05,08,98948,75249,52557,22692,43.2,2016/05/08(21:00)
2016,05,07,98948,75354,53034,22320,42.1,2016/05/07(21:00)
2016,05,06,98948,80494,57534,22960,39.9,2016/05/06(11:00)
2016,05,05,98948,78957,56793,22164,39,2016/05/05(21:00)
2016,05,04,98948,81780,60799,20981,34.5,2016/05/04(10:00)
2016,05,03,98948,81749,64682,17067,26.4,2016/05/03(11:00)
2016,05,02,98948,80915,63788,17127,26.8,2016/05/02(17:00)
2016,05,01,98948,75485,52528,22957,43.7,2016/05/01(21:00)
2016,04,30,98948,76444,54824,21620,39.4,2016/04/30(11:00)
2016,04,29,98948,80891,61635,19256,31.2,2016/04/29(11:00)
2016,04,28,98948,81851,62761,19090,30.4,2016/04/28(11:00)
2016,04,27,98948,81832,64566,17266,26.7,2016/04/27(15:00)
2016,04,26,98948,80954,63140,17814,28.2,2016/04/26(17:00)
2016,04,25,98948,81817,61770,20047,32.5,2016/04/25(20:00)
2016,04,24,98948,78123,53148,24975,47,2016/04/24(21:00)
2016,04,23,98948,78138,56709,21429,37.8,2016/04/23(11:00)
2016,04,22,98948,81163,62611,18552,29.6,2016/04/22(17:00)
2016,04,21,98948,81849,65489,16360,25,2016/04/21(11:00)
2016,04,20,98796,81465,63040,18425,29.2,2016/04/20(17:00)
2016,04,19,98796,82269,63025,19244,30.5,2016/04/19(20:00)
2016,04,18,98796,82442,63016,19426,30.8,2016/04/18(20:00)
2016,04,17,98796,76164,53629,22535,42,2016/04/17(21:00)
2016,04,16,98796,76726,56605,20121,35.5,2016/04/16(12:00)
2016,04,15,98796,84266,62730,21536,34.3,2016/04/15(10:00)
2016,04,14,98796,83922,64045,19877,31,2016/04/14(11:00)
2016,04,13,98796,85256,61592,23664,38.4,2016/04/13(11:00)
2016,04,12,98796,84871,63629,21242,33.4,2016/04/12(10:00)
2016,04,11,98796,84966,63842,21124,33.1,2016/04/11(20:00)
2016,04,10,98796,80722,53991,26731,49.5,2016/04/10(21:00)
2016,04,09,98796,79445,56897,22548,39.6,2016/04/09(11:00)
2016,04,08,98796,85758,64364,21394,33.2,2016/04/08(10:00)
2016,04,07,98796,86048,65765,20283,30.8,2016/04/07(10:00)
2016,04,06,98796,86168,63973,22195,34.7,2016/04/06(10:00)
2016,04,05,98796,85987,63821,22166,34.7,2016/04/05(10:00)
2016,04,04,98796,86308,64622,21686,33.6,2016/04/04(11:00)
2016,04,03,98796,80805,54758,26047,47.6,2016/04/03(23:00)
2016,04,02,98796,81090,56000,25090,44.8,2016/04/02(11:00)
2016,04,01,98796,89366,63321,26045,41.1,2016/04/01(10:00)
2016,03,31,98796,88016,65372,22644,34.6,2016/03/31(10:00)
2016,03,30,98796,88014,65286,22728,34.8,2016/03/30(10:00)
2016,03,29,98796,87122,66996,20126,30,2016/03/29(10:00)
2016,03,28,98796,87978,66453,21525,32.4,2016/03/28(10:00)
2016,03,27,98796,83309,56066,27243,48.6,2016/03/27(23:00)
2016,03,26,98796,86163,59204,26959,45.5,2016/03/26(01:00)
2016,03,25,98796,88950,67803,21147,31.2,2016/03/25(10:00)
2016,03,24,98796,88005,67411,20594,30.5,2016/03/24(10:00)
2016,03,23,98796,86797,66518,20279,30.5,2016/03/23(10:00)
2016,03,22,98796,86880,66468,20412,30.7,2016/03/22(10:00)
2016,03,21,98796,90330,65976,24354,36.9,2016/03/21(10:00)
2016,03,20,98796,85864,55692,30172,54.2,2016/03/20(23:00)
2016,03,19,98796,84259,58798,25461,43.3,2016/03/19(10:00)
2016,03,18,98796,88762,68855,19907,28.9,2016/03/18(10:00)
2016,03,17,98796,88176,68585,19591,28.6,2016/03/17(10:00)
2016,03,16,98796,85861,70048,15813,22.6,2016/03/16(10:00)
2016,03,15,98796,88001,71249,16752,23.5,2016/03/15(10:00)
2016,03,14,98796,85600,71811,13789,19.2,2016/03/14(10:00)
2016,03,13,98796,81728,58472,23256,39.8,2016/03/13(24:00)
2016,03,12,98796,80319,63026,17293,27.4,2016/03/12(11:00)
2016,03,11,98796,86383,73355,13028,17.8,2016/03/11(10:00)
2016,03,10,98796,84830,73534,11296,15.4,2016/03/10(10:00)
2016,03,09,98796,85282,73394,11888,16.2,2016/03/09(10:00)
2016,03,08,98796,84776,71496,13280,18.6,2016/03/08(11:00)
2016,03,07,98796,85296,68654,16642,24.2,2016/03/07(10:00)
2016,03,06,98796,80856,56541,24315,43,2016/03/06(23:00)
2016,03,05,98796,79847,61088,18759,30.7,2016/03/05(11:00)
2016,03,04,98796,83372,71181,12191,17.1,2016/03/04(10:00)
2016,03,03,98796,84410,73339,11071,15.1,2016/03/03(10:00)
2016,03,02,98796,85097,75697,9400,12.4,2016/03/02(10:00)
2016,03,01,98796,85747,65659,20088,30.6,2016/03/01(24:00)
2016,02,29,98796,87502,75081,12421,16.5,2016/02/29(11:00)
2016,02,28,98796,82309,60454,21855,36.2,2016/02/28(24:00)
2016,02,27,98190,85576,62835,22741,36.2,2016/02/27(11:00)
2016,02,26,98190,88805,74143,14662,19.8,2016/02/26(10:00)
2016,02,25,98190,89978,74692,15286,20.5,2016/02/25(10:00)
2016,02,24,98190,91005,74895,16110,21.5,2016/02/24(11:00)
2016,02,23,98190,91110,73020,18090,24.8,2016/02/23(10:00)
2016,02,22,98190,91271,75055,16216,21.6,2016/02/22(11:00)
2016,02,21,98190,86329,61244,25085,41,2016/02/21(24:00)
2016,02,20,98190,87494,63910,23584,36.9,2016/02/20(11:00)
2016,02,19,98190,90889,73525,17364,23.6,2016/02/19(11:00)
2016,02,18,98190,90451,74491,15960,21.4,2016/02/18(11:00)
2016,02,17,98190,89842,75386,14456,19.2,2016/02/17(10:00)
2016,02,16,98190,90441,77048,13393,17.4,2016/02/16(11:00)
2016,02,15,98190,90405,76750,13655,17.8,2016/02/15(11:00)
2016,02,14,98190,87554,62099,25455,41,2016/02/14(24:00)
2016,02,13,98190,85427,61690,23737,38.5,2016/02/13(11:00)
2016,02,12,98190,88403,72165,16238,22.5,2016/02/12(11:00)
2016,02,11,98190,93000,71422,21578,30.2,2016/02/11(11:00)
2016,02,10,98190,89176,58442,30734,52.6,2016/02/10(24:00)
2016,02,09,98190,86697,56144,30553,54.4,2016/02/09(24:00)
2016,02,08,98190,85210,54354,30856,56.8,2016/02/08(01:00)
2016,02,07,98190,85242,60053,25189,41.9,2016/02/07(01:00)
2016,02,06,98190,88569,64785,23784,36.7,2016/02/06(01:00)
2016,02,05,98190,93589,76775,16814,21.9,2016/02/05(10:00)
2016,02,04,98190,93417,78046,15371,19.7,2016/02/04(10:00)
2016,02,03,98190,92743,79833,12910,16.2,2016/02/03(10:00)
2016,02,02,98190,93809,80020,13789,17.2,2016/02/02(10:00)
2016,02,01,98190,93179,79041,14138,17.9,2016/02/01(11:00)
2016,01,31,98190,92631,63782,28849,45.2,2016/01/31(24:00)
2016,01,30,98190,88397,67071,21326,31.8,2016/01/30(11:00)
2016,01,29,98190,93196,78730,14466,18.4,2016/01/29(11:00)
2016,01,28,98190,93706,80274,13432,16.7,2016/01/28(11:00)
2016,01,27,98190,92222,79191,13031,16.5,2016/01/27(11:00)
2016,01,26,98190,93157,81877,11280,13.8,2016/01/26(11:00)
2016,01,25,98190,93248,82811,10437,12.6,2016/01/25(11:00)
2016,01,24,98190,92052,67807,24245,35.8,2016/01/24(24:00)
2016,01,23,98190,93437,71326,22111,31,2016/01/23(11:00)
2016,01,22,98190,94529,80802,13727,17,2016/01/22(11:00)
2016,01,21,98190,94793,82972,11821,14.2,2016/01/21(11:00)
2016,01,20,98190,94868,81861,13007,15.9,2016/01/20(11:00)
2016,01,19,98190,95511,82123,13388,16.3,2016/01/19(11:00)
2016,01,18,98190,95589,78462,17127,21.8,2016/01/18(18:00)
2016,01,17,98190,91948,61528,30420,49.4,2016/01/17(24:00)
2016,01,16,98190,90209,66852,23357,34.9,2016/01/16(11:00)
2016,01,15,97553,93817,77494,16323,21.1,2016/01/15(10:00)
2016,01,14,97553,94597,78269,16328,20.9,2016/01/14(10:00)
2016,01,13,97553,95050,78819,16231,20.6,2016/01/13(10:00)
2016,01,12,97553,95128,78291,16837,21.5,2016/01/12(10:00)
2016,01,11,97553,94970,76764,18206,23.7,2016/01/11(10:00)
2016,01,10,97553,94012,61698,32314,52.4,2016/01/10(24:00)
2016,01,09,97553,93863,66036,27827,42.1,2016/01/09(11:00)
2016,01,08,97553,93845,76982,16863,21.9,2016/01/08(10:00)
2016,01,07,97553,94730,76531,18199,23.8,2016/01/07(10:00)
2016,01,06,97553,91498,76602,14896,19.4,2016/01/06(10:00)
2016,01,05,97553,91944,76909,15035,19.5,2016/01/05(11:00)
2016,01,04,97553,91005,71516,19489,27.3,2016/01/04(10:00)
2016,01,03,97553,90033,58280,31753,54.5,2016/01/03(24:00)
2016,01,02,97553,89449,58562,30887,52.7,2016/01/02(24:00)
2016,01,01,97553,90203,59662,30541,51.2,2016/01/01(01:00)
2015,12,31,97649,90899,69887,21012,30.1,2015/12/31(10:00)
2015,12,30,97649,92185,74257,17928,24.1,2015/12/30(10:00)
2015,12,29,97649,92413,76087,16326,21.5,2015/12/29(10:00)
2015,12,28,97649,91740,75834,15906,21,2015/12/28(10:00)
2015,12,27,97649,89152,61544,27608,44.9,2015/12/27(24:00)
2015,12,26,97649,91013,61301,29712,48.5,2015/12/26(24:00)
2015,12,25,97649,90707,62658,28049,44.8,2015/12/25(24:00)
2015,12,24,97649,91827,72706,19121,26.3,2015/12/24(10:00)
2015,12,23,97649,90339,72896,17443,23.9,2015/12/23(10:00)
2015,12,22,97649,91101,74781,16320,21.8,2015/12/22(10:00)
2015,12,21,97649,91650,75526,16124,21.3,2015/12/21(11:00)
2015,12,20,97649,89053,60678,28375,46.8,2015/12/20(01:00)
2015,12,19,97649,88888,65145,23743,36.4,2015/12/19(11:00)
2015,12,18,97649,89191,77282,11909,15.4,2015/12/18(10:00)
2015,12,17,97649,87841,76340,11501,15.1,2015/12/17(10:00)
2015,12,16,97649,87330,73369,13961,19,2015/12/16(10:00)
2015,12,15,97649,86324,71928,14396,20,2015/12/15(10:00)
2015,12,14,97649,86639,71845,14794,20.6,2015/12/14(11:00)
2015,12,13,97649,84224,58055,26169,45.1,2015/12/13(24:00)
2015,12,12,97649,84692,61903,22789,36.8,2015/12/12(11:00)
2015,12,11,97649,86897,71554,15343,21.4,2015/12/11(10:00)
2015,12,10,97649,86861,72052,14809,20.6,2015/12/10(11:00)
2015,12,09,97649,86975,73300,13675,18.7,2015/12/09(10:00)
2015,12,08,97649,86628,73169,13459,18.4,2015/12/08(10:00)
2015,12,07,97649,86035,73760,12275,16.6,2015/12/07(10:00)
2015,12,06,97649,83940,59924,24016,40.1,2015/12/06(24:00)
2015,12,05,97649,82735,62921,19814,31.5,2015/12/05(11:00)
2015,12,04,97649,87385,74655,12730,17.1,2015/12/04(10:00)
2015,12,03,97649,91101,74781,16320,21.8,2015/12/03(10:00)
2015,12,02,97649,88032,71955,16077,22.3,2015/12/02(11:00)
2015,12,01,97649,87826,72117,15709,21.8,2015/12/01(10:00)
2015,11,30,97649,86474,70678,15796,22.3,2015/11/30(10:00)
2015,11,29,97649,76811,58656,18155,31,2015/11/29(01:00)
2015,11,28,97649,80131,63822,16309,25.6,2015/11/28(11:00)
2015,11,27,97649,87180,73965,13215,17.9,2015/11/27(11:00)
2015,11,26,97649,87156,73301,13855,18.9,2015/11/26(18:00)
2015,11,25,97649,84776,70103,14673,20.9,2015/11/25(11:00)
2015,11,24,97649,84583,67791,16792,24.8,2015/11/24(18:00)
2015,11,23,97476,83739,66940,16799,25.1,2015/11/23(18:00)
2015,11,22,97476,76676,54692,21984,40.2,2015/11/22(23:00)
2015,11,21,97476,78079,58603,19476,33.2,2015/11/21(11:00)
2015,11,20,97476,82380,65527,16853,25.7,2015/11/20(10:00)
2015,11,19,97476,82445,66358,16087,24.2,2015/11/19(18:00)
2015,11,18,97476,81932,66812,15120,22.6,2015/11/18(17:00)
2015,11,17,97476,81452,65056,16396,25.2,2015/11/17(11:00)
2015,11,16,97476,81378,65914,15464,23.5,2015/11/16(18:00)
2015,11,15,97476,75023,54480,20543,37.7,2015/11/15(23:00)
2015,11,14,97476,78775,57776,20999,36.3,2015/11/14(11:00)
2015,11,13,97476,82613,66214,16399,24.8,2015/11/13(11:00)
2015,11,12,97476,83048,64451,18597,28.9,2015/11/12(19:00)
2015,11,11,97476,81643,64221,17422,27.1,2015/11/11(10:00)
2015,11,10,97476,82102,65234,16868,25.9,2015/11/10(19:00)
2015,11,09,97476,81759,65021,16738,25.7,2015/11/09(18:00)
2015,11,08,97476,75984,54098,21886,40.5,2015/11/08(19:00)
2015,11,07,97476,76226,58830,17396,29.6,2015/11/07(12:00)
2015,11,06,97476,81267,63785,17482,27.4,2015/11/06(18:00)
2015,11,05,97476,80033,63626,16407,25.8,2015/11/05(10:00)
2015,11,04,97476,79933,64007,15926,24.9,2015/11/04(19:00)
2015,11,03,97476,80177,64524,15653,24.3,2015/11/03(19:00)
2015,11,02,97476,80407,64439,15968,24.8,2015/11/02(19:00)
2015,11,01,97476,72113,54224,17889,33,2015/11/01(19:00)
2015,10,31,97476,73327,56721,16606,29.3,2015/10/31(19:00)
2015,10,30,96828,80518,64239,16279,25.3,2015/10/30(19:00)
2015,10,29,96828,81438,64520,16918,26.2,2015/10/29(19:00)
2015,10,28,96828,80177,63356,16821,26.5,2015/10/28(19:00)
2015,10,27,96828,80026,64385,15641,24.3,2015/10/27(19:00)
2015,10,26,96828,79075,63891,15184,23.8,2015/10/26(19:00)
2015,10,25,96828,69680,52758,16922,32.1,2015/10/25(20:00)
2015,10,24,96828,70752,55946,14806,26.5,2015/10/24(11:00)
2015,10,23,96828,75294,63199,12095,19.1,2015/10/23(19:00)
2015,10,22,96828,75761,64211,11550,18,2015/10/22(19:00)
2015,10,21,96828,75341,64102,11239,17.5,2015/10/21(19:00)
2015,10,20,96828,75208,65040,10168,15.6,2015/10/20(19:00)
2015,10,19,96828,74906,64033,10873,17,2015/10/19(19:00)
2015,10,18,96828,71642,53494,18148,33.9,2015/10/18(20:00)
2015,10,17,96828,71663,56043,15620,27.9,2015/10/17(11:00)
2015,10,16,96828,74633,63790,10843,17,2015/10/16(19:00)
2015,10,15,96828,74187,64576,9611,14.9,2015/10/15(19:00)
2015,10,14,96828,73097,63625,9472,14.9,2015/10/14(01:00)
2015,10,13,96828,73167,63812,9355,14.7,2015/10/13(19:00)
2015,10,12,96828,74544,63312,11232,17.7,2015/10/12(19:00)
2015,10,11,96828,68218,52812,15406,29.2,2015/10/11(20:00)
2015,10,10,96828,69590,54244,15346,28.3,2015/10/10(19:00)
2015,10,09,96828,72391,58063,14328,24.7,2015/10/09(20:00)
2015,10,08,96828,76750,63497,13253,20.9,2015/10/08(19:00)
2015,10,07,96828,76699,64311,12388,19.3,2015/10/07(17:00)
2015,10,06,96828,78198,64572,13626,21.1,2015/10/06(19:00)
2015,10,05,96828,78704,63691,15013,23.6,2015/10/05(19:00)
2015,10,04,96828,72856,53269,19587,36.8,2015/10/04(20:00)
2015,10,03,96828,72319,55982,16337,29.2,2015/10/03(20:00)
2015,10,02,96828,80112,62303,17809,28.6,2015/10/02(19:00)
2015,10,01,96828,80604,65322,15282,23.4,2015/10/01(17:00)
2015,09,30,96828,80325,61103,19222,31.5,2015/09/30(15:00)
2015,09,29,96828,74792,52106,22686,43.5,2015/09/29(20:00)
2015,09,28,96828,71623,47846,23777,49.7,2015/09/28(20:00)
2015,09,27,96828,73331,44389,28942,65.2,2015/09/27(20:00)
2015,09,26,96828,74353,49043,25310,51.6,2015/09/26(01:00)
2015,09,25,96828,85334,62960,22374,35.5,2015/09/25(11:00)
2015,09,24,96828,82560,67067,15493,23.1,2015/09/24(17:00)
2015,09,23,96828,83887,66815,17072,25.6,2015/09/23(15:00)
2015,09,22,96828,83452,68297,15155,22.2,2015/09/22(17:00)
2015,09,21,96828,83380,67755,15625,23.1,2015/09/21(17:00)
2015,09,20,96828,73283,55707,17576,31.6,2015/09/20(20:00)
2015,09,19,96828,74695,59505,15190,25.5,2015/09/19(15:00)
2015,09,18,96828,82599,66562,16037,24.1,2015/09/18(17:00)
2015,09,17,96828,81586,66608,14978,22.5,2015/09/17(17:00)
2015,09,16,96828,82133,66232,15901,24,2015/09/16(17:00)
2015,09,15,96828,81410,66393,15017,22.6,2015/09/15(17:00)
2015,09,14,96828,81625,66672,14953,22.4,2015/09/14(17:00)
2015,09,13,96828,70323,53986,16337,30.3,2015/09/13(20:00)
2015,09,12,96828,72775,59147,13628,23,2015/09/12(11:00)
2015,09,11,96828,81573,67735,13838,20.4,2015/09/11(15:00)
2015,09,10,96828,80419,67993,12426,18.3,2015/09/10(17:00)
2015,09,09,96828,80598,67573,13025,19.3,2015/09/09(17:00)
2015,09,08,96828,82583,67206,15377,22.9,2015/09/08(17:00)
2015,09,07,96828,83216,68207,15009,22,2015/09/07(17:00)
2015,09,06,96828,74779,55172,19607,35.5,2015/09/06(20:00)
2015,09,05,96828,76266,62551,13715,21.9,2015/09/05(12:00)
2015,09,04,96828,83274,72121,11153,15.5,2015/09/04(15:00)
2015,09,03,96828,84154,71937,12217,17,2015/09/03(15:00)
2015,09,02,96828,84561,72236,12325,17.1,2015/09/02(15:00)
2015,09,01,96828,85102,72991,12111,16.6,2015/09/01(15:00)
2015,08,31,96828,87868,72639,15229,21,2015/08/31(15:00)
2015,08,30,96828,77848,57913,19935,34.4,2015/08/30(20:00)
2015,08,29,96828,77956,62100,15856,25.5,2015/08/29(15:00)
2015,08,28,96828,86244,70617,15627,22.1,2015/08/28(15:00)
2015,08,27,96828,86300,69840,16460,23.6,2015/08/27(15:00)
2015,08,26,96828,86665,67939,18726,27.6,2015/08/26(15:00)
2015,08,25,96828,86548,68423,18125,26.5,2015/08/25(11:00)
2015,08,24,96828,86169,73542,12627,17.2,2015/08/24(15:00)
2015,08,23,96828,76044,59361,16683,28.1,2015/08/23(20:00)
2015,08,22,96828,78190,64772,13418,20.7,2015/08/22(01:00)
2015,08,21,96828,87359,72231,15128,20.9,2015/08/21(15:00)
2015,08,20,96828,87278,74079,13199,17.8,2015/08/20(15:00)
2015,08,19,96828,87191,75218,11973,15.9,2015/08/19(15:00)
2015,08,18,96828,86170,75600,10570,14,2015/08/18(15:00)
2015,08,17,96828,87724,74469,13255,17.8,2015/08/17(17:00)
2015,08,16,96828,80270,59581,20689,34.7,2015/08/16(20:00)
2015,08,15,96828,81084,64512,16572,25.7,2015/08/15(15:00)
2015,08,14,96828,86408,69377,17031,24.5,2015/08/14(15:00)
2015,08,13,96828,87995,74160,13835,18.7,2015/08/13(15:00)
2015,08,12,96828,87919,73511,14408,19.6,2015/08/12(17:00)
2015,08,11,96828,87841,76028,11813,15.5,2015/08/11(15:00)
2015,08,10,96828,88000,76504,11496,15,2015/08/10(15:00)
2015,08,09,96828,79815,62661,17154,27.4,2015/08/09(21:00)
2015,08,08,96828,82097,69683,12414,17.8,2015/08/08(12:00)
2015,08,07,96828,89595,76916,12679,16.5,2015/08/07(15:00)
2015,08,06,96828,89876,75159,14717,19.6,2015/08/06(15:00)
2015,08,05,96828,90601,69924,20677,29.6,2015/08/05(17:00)
2015,08,04,96828,90475,67177,23298,34.7,2015/08/04(17:00)
2015,08,03,96828,89520,65735,23785,36.2,2015/08/03(17:00)
2015,08,02,96828,84378,60346,24032,39.8,2015/08/02(21:00)
2015,08,01,96828,83707,62162,21545,34.7,2015/08/01(15:00)
2015,07,31,96828,89766,74429,15337,20.6,2015/07/31(15:00)
2015,07,30,96828,89654,76696,12958,16.9,2015/07/30(15:00)
2015,07,29,96828,90010,74624,15386,20.6,2015/07/29(15:00)
2015,07,28,96828,89955,76179,13776,18.1,2015/07/28(15:00)
2015,07,27,96828,89481,73976,15505,21,2015/07/27(15:00)
2015,07,26,96828,80528,60454,20074,33.2,2015/07/26(21:00)
2015,07,25,96828,81887,64202,17685,27.5,2015/07/25(12:00)
2015,07,24,95681,88145,71742,16403,22.9,2015/07/24(12:00)
2015,07,23,95681,88247,75266,12981,17.2,2015/07/23(15:00)
2015,07,22,95681,89153,74740,14413,19.3,2015/07/22(15:00)
2015,07,21,95681,89942,73302,16640,22.7,2015/07/21(15:00)
2015,07,20,95681,89174,72128,17046,23.6,2015/07/20(15:00)
2015,07,19,95681,83966,57172,26794,46.9,2015/07/19(21:00)
2015,07,18,95681,85770,60151,25619,42.6,2015/07/18(15:00)
2015,07,17,95681,90868,67045,23823,35.5,2015/07/17(15:00)
2015,07,16,95681,90304,69032,21272,30.8,2015/07/16(15:00)
2015,07,15,95681,89665,73691,15974,21.7,2015/07/15(15:00)
2015,07,14,95681,89895,72249,17646,24.4,2015/07/14(15:00)
2015,07,13,95681,90691,67906,22785,33.6,2015/07/13(17:00)
2015,07,12,95681,84475,57062,27413,48,2015/07/12(21:00)
2015,07,11,95681,83597,65687,17910,27.3,2015/07/11(15:00)
2015,07,10,95681,89158,71612,17546,24.5,2015/07/10(15:00)
2015,07,09,95681,89194,69524,19670,28.3,2015/07/09(15:00)
2015,07,08,95681,90117,67481,22636,33.5,2015/07/08(15:00)
2015,07,07,95681,89693,67267,22426,33.3,2015/07/07(15:00)
2015,07,06,95681,89839,68718,21121,30.7,2015/07/06(15:00)
2015,07,05,95681,85946,54730,31216,57,2015/07/05(21:00)
2015,07,04,95681,87485,58508,28977,49.5,2015/07/04(15:00)
2015,07,03,95681,89885,67572,22313,33,2015/07/03(15:00)
2015,07,02,95681,89114,68058,21056,30.9,2015/07/02(15:00)
2015,07,01,95681,88897,67370,21527,32,2015/07/01(15:00)
2015,06,30,95681,87788,68545,19243,28.1,2015/06/30(15:00)
2015,06,29,95681,86322,69381,16941,24.4,2015/06/29(15:00)
2015,06,28,95681,80620,55007,25613,46.6,2015/06/28(21:00)
2015,06,27,95681,80748,59267,21481,36.2,2015/06/27(12:00)
2015,06,26,95681,86757,66006,20751,31.4,2015/06/26(15:00)
2015,06,25,95681,84325,68538,15787,23,2015/06/25(15:00)
2015,06,24,95681,84047,69882,14165,20.3,2015/06/24(15:00)
2015,06,23,95681,83419,69046,14373,20.8,2015/06/23(17:00)
2015,06,22,95681,83289,67716,15573,23,2015/06/22(15:00)
2015,06,21,95681,76306,54945,21361,38.9,2015/06/21(21:00)
2015,06,20,95681,78686,59363,19323,32.6,2015/06/20(12:00)
2015,06,19,95681,82650,68273,14377,21.1,2015/06/19(15:00)
2015,06,18,95681,82773,68456,14317,20.9,2015/06/18(16:00)
2015,06,17,95681,82024,68766,13258,19.3,2015/06/17(15:00)
2015,06,16,95681,82348,69508,12840,18.5,2015/06/16(16:00)
2015,06,15,95681,83188,69112,14076,20.4,2015/06/15(15:00)
2015,06,14,95681,78369,55037,23332,42.4,2015/06/14(21:00)
2015,06,13,95681,79295,60698,18597,30.6,2015/06/13(15:00)
2015,06,12,95681,82531,67843,14688,21.6,2015/06/12(17:00)
2015,06,11,95681,80871,67071,13800,20.6,2015/06/11(15:00)
2015,06,10,95681,79594,68573,11021,16.1,2015/06/10(15:00)
2015,06,09,95681,79795,66364,13431,20.2,2015/06/09(17:00)
2015,06,08,95681,79638,65474,14164,21.6,2015/06/08(17:00)
2015,06,07,95681,76856,53713,23143,43.1,2015/06/07(21:00)
2015,06,06,95681,74606,56114,18492,33,2015/06/06(15:00)
2015,06,05,95681,77774,63284,14490,22.9,2015/06/05(11:00)
2015,06,04,95681,78049,66264,11785,17.8,2015/06/04(15:00)
2015,06,03,95681,78028,65327,12701,19.4,2015/06/03(17:00)
2015,06,02,95681,79512,66172,13340,20.2,2015/06/02(15:00)
2015,06,01,95681,79227,65718,13509,20.6,2015/06/01(17:00)
2015,05,31,95681,75956,53681,22275,41.5,2015/05/31(21:00)
2015,05,30,95681,76038,58526,17512,29.9,2015/05/30(11:00)
2015,05,29,95681,76874,67107,9767,14.6,2015/05/29(15:00)
2015,05,28,95681,77532,66923,10609,15.9,2015/05/28(17:00)
2015,05,27,95681,76914,66092,10822,16.4,2015/05/27(17:00)
2015,05,26,95681,76617,65143,11474,17.6,2015/05/26(17:00)
2015,05,25,95681,73296,56379,16917,30,2015/05/25(21:00)
2015,05,24,95681,72521,51931,20590,39.6,2015/05/24(21:00)
2015,05,23,95681,72507,56701,15806,27.9,2015/05/23(12:00)
2015,05,22,95681,78663,63627,15036,23.6,2015/05/22(15:00)
2015,05,21,95681,77968,63145,14823,23.5,2015/05/21(17:00)
2015,05,20,95681,76699,62147,14552,23.4,2015/05/20(15:00)
2015,05,19,95681,76833,63092,13741,21.8,2015/05/19(17:00)
2015,05,18,95365,75638,62864,12774,20.3,2015/05/18(15:00)
2015,05,17,95365,72600,52474,20126,38.4,2015/05/17(21:00)
2015,05,16,95365,72529,56217,16312,29,2015/05/16(11:00)
2015,05,15,95365,78307,64069,14238,22.2,2015/05/15(15:00)
2015,05,14,95365,78219,63827,14392,22.5,2015/05/14(17:00)
2015,05,13,95365,78224,62025,16199,26.1,2015/05/13(17:00)
2015,05,12,95365,79682,61499,18183,29.6,2015/05/12(20:00)
2015,05,11,95365,79358,62407,16951,27.2,2015/05/11(17:00)
2015,05,10,95365,76585,52096,24489,47,2015/05/10(21:00)
2015,05,09,95365,76643,55800,20843,37.4,2015/05/09(11:00)
2015,05,08,95365,79521,62005,17516,28.2,2015/05/08(15:00)
2015,05,07,95365,78713,61489,17224,28,2015/05/07(17:00)
2015,05,06,95365,79932,61056,18876,30.9,2015/05/06(17:00)
2015,05,05,95365,78856,55179,23677,42.9,2015/05/05(21:00)
2015,05,04,95365,78474,57053,21421,37.5,2015/05/04(20:00)
2015,05,03,95365,75270,51611,23659,45.8,2015/05/03(21:00)
2015,05,02,95365,75723,53086,22637,42.6,2015/05/02(21:00)
2015,05,01,95365,78162,54959,23203,42.2,2015/05/01(21:00)
2015,04,30,95365,80456,62204,18252,29.3,2015/04/30(15:00)
2015,04,29,95365,80007,63540,16467,25.9,2015/04/29(11:00)
2015,04,28,95365,80029,62730,17299,27.6,2015/04/28(15:00)
2015,04,27,95365,80964,61897,19067,30.8,2015/04/27(17:00)
2015,04,26,95365,77061,52441,24620,46.9,2015/04/26(21:00)
2015,04,25,95365,78643,55101,23542,42.7,2015/04/25(11:00)
2015,04,24,95365,81058,61939,19119,30.9,2015/04/24(10:00)
2015,04,23,95365,81142,62522,18620,29.8,2015/04/23(10:00)
2015,04,22,95365,81554,62719,18835,30,2015/04/22(10:00)
2015,04,21,95365,81727,63196,18531,29.3,2015/04/21(10:00)
2015,04,20,95365,81806,65618,16188,24.7,2015/04/20(11:00)
2015,04,19,95365,77617,54102,23515,43.5,2015/04/19(23:00)
2015,04,18,95365,78532,56800,21732,38.3,2015/04/18(11:00)
2015,04,17,95365,82262,63104,19158,30.4,2015/04/17(10:00)
2015,04,16,95365,81764,65211,16553,25.4,2015/04/16(15:00)
2015,04,15,95365,81194,65086,16108,24.7,2015/04/15(10:00)
2015,04,14,95365,82017,65786,16231,24.7,2015/04/14(10:00)
2015,04,13,95365,80515,64956,15559,24,2015/04/13(11:00)
2015,04,12,95365,76842,54000,22842,42.3,2015/04/12(23:00)
2015,04,11,95365,78219,56499,21720,38.4,2015/04/11(01:00)
2015,04,10,95365,80145,64409,15736,24.4,2015/04/10(10:00)
2015,04,09,95365,79044,65751,13293,20.2,2015/04/09(10:00)
2015,04,08,95365,79635,66582,13053,19.6,2015/04/08(10:00)
2015,04,07,95365,80698,66436,14262,21.5,2015/04/07(10:00)
2015,04,06,95365,80882,65749,15133,23,2015/04/06(11:00)
2015,04,05,95365,77236,54596,22640,41.5,2015/04/05(23:00)
2015,04,04,95365,77017,56498,20519,36.3,2015/04/04(11:00)
2015,04,03,95365,83318,65030,18288,28.1,2015/04/03(10:00)
2015,04,02,95365,83739,64708,19031,29.4,2015/04/02(10:00)
2015,04,01,95365,85206,65584,19622,29.9,2015/04/01(11:00)
2015,03,31,95635,84751,65746,19005,28.9,2015/03/31(11:00)
2015,03,30,95365,84215,63670,20545,32.3,2015/03/30(10:00)
2015,03,29,95365,81444,54591,26853,49.2,2015/03/29(23:00)
2015,03,28,95365,81966,57762,24204,41.9,2015/03/28(10:00)
2015,03,27,95365,84373,66385,17988,27.1,2015/03/27(10:00)
2015,03,26,95365,85354,66899,18455,27.6,2015/03/26(10:00)
2015,03,25,95365,85329,67829,17500,25.8,2015/03/25(10:00)
2015,03,24,95365,84153,67669,16484,24.4,2015/03/24(10:00)
2015,03,23,94102,84643,66568,18075,27.2,2015/03/23(20:00)
2015,03,22,94102,76981,55520,21461,38.7,2015/03/22(23:00)
2015,03,21,94102,81538,57464,24074,41.9,2015/03/21(10:00)
2015,03,20,94102,83296,66148,17148,25.9,2015/03/20(10:00)
2015,03,19,94102,83965,66798,17167,25.7,2015/03/19(10:00)
2015,03,18,94102,83181,68802,14379,20.9,2015/03/18(10:00)
2015,03,17,94102,82075,68242,13833,20.3,2015/03/17(10:00)
2015,03,16,94102,81997,69413,12584,18.1,2015/03/16(10:00)
2015,03,15,94102,80077,57815,22262,38.5,2015/03/15(23:00)
2015,03,14,94102,80398,61622,18776,30.5,2015/03/14(11:00)
2015,03,13,94102,82119,71828,10291,14.3,2015/03/13(10:00)
2015,03,12,94102,83829,72718,11111,15.3,2015/03/12(10:00)
2015,03,11,94102,84174,73483,10691,14.5,2015/03/11(10:00)
2015,03,10,94102,84910,75375,9535,12.7,2015/03/10(01:00)
2015,03,09,94102,84130,70053,14077,20.1,2015/03/09(20:00)
2015,03,08,94102,80904,57792,23112,40,2015/03/08(01:00)
2015,03,07,94102,81505,62615,18890,30.2,2015/03/07(11:00)
2015,03,06,94102,85201,73317,11884,16.2,2015/03/06(10:00)
2015,03,05,94102,85795,74289,11506,15.5,2015/03/05(10:00)
2015,03,04,94102,87216,74815,12401,16.6,2015/03/04(10:00)
2015,03,03,94102,86423,74129,12294,16.6,2015/03/03(11:00)
2015,03,02,94102,87732,71982,15750,21.9,2015/03/02(10:00)
2015,03,01,94102,85648,59786,25862,43.3,2015/03/01(23:00)
2015,02,28,94102,86997,64908,22089,34,2015/02/28(11:00)
2015,02,27,94102,89400,73371,16029,21.8,2015/02/27(01:00)
2015,02,26,94102,88445,70678,17767,25.1,2015/02/26(10:00)
2015,02,25,94102,88372,71105,17267,24.3,2015/02/25(10:00)
2015,02,24,94102,88612,71195,17417,24.5,2015/02/24(10:00)
2015,02,23,94102,88324,71663,16661,23.2,2015/02/23(10:00)
2015,02,22,94102,86653,57926,28727,49.6,2015/02/22(24:00)
2015,02,21,94102,86220,54759,31461,57.5,2015/02/21(24:00)
2015,02,20,94102,85982,52756,33226,63,2015/02/20(24:00)
2015,02,19,94102,86270,52266,34004,65.1,2015/02/19(24:00)
2015,02,18,94102,88092,58143,29949,51.5,2015/02/18(01:00)
2015,02,17,94102,89268,69509,19759,28.4,2015/02/17(10:00)
2015,02,16,94102,89185,72707,16478,22.7,2015/02/16(11:00)
2015,02,15,94102,86990,60953,26037,42.7,2015/02/15(01:00)
2015,02,14,94102,84842,66381,18461,27.8,2015/02/14(11:00)
2015,02,13,94102,88296,75325,12971,17.2,2015/02/13(10:00)
2015,02,12,94102,88782,74263,14519,19.6,2015/02/12(10:00)
2015,02,11,94102,87281,74650,12631,16.9,2015/02/11(10:00)
2015,02,10,94102,88298,75019,13279,17.7,2015/02/10(10:00)
2015,02,09,94102,87926,78790,9136,11.6,2015/02/09(11:00)
2015,02,08,94102,86036,64160,21876,34.1,2015/02/08(24:00)
2015,02,07,94102,85284,66074,19210,29.1,2015/02/07(11:00)
2015,02,06,94102,88162,75326,12836,17,2015/02/06(10:00)
2015,02,05,94102,89353,75568,13785,18.2,2015/02/05(10:00)
2015,02,04,94102,88986,75795,13191,17.4,2015/02/04(10:00)
2015,02,03,94102,89487,76039,13448,17.7,2015/02/03(10:00)
2015,02,02,94102,89181,76071,13110,17.2,2015/02/02(11:00)
2015,02,01,94102,87725,61909,25816,41.7,2015/02/01(01:00)
2015,01,31,94102,88021,66124,21897,33.1,2015/01/31(11:00)
2015,01,30,94102,90133,75223,14910,19.8,2015/01/30(10:00)
2015,01,29,94102,90680,76407,14273,18.7,2015/01/29(11:00)
2015,01,28,94102,90033,76557,13476,17.6,2015/01/28(10:00)
2015,01,27,93201,90908,74412,16496,22.2,2015/01/27(10:00)
2015,01,26,93201,89867,73232,16635,22.7,2015/01/26(11:00)
2015,01,25,93201,90436,60041,30395,50.6,2015/01/25(01:00)
2015,01,24,93201,89975,64081,25894,40.4,2015/01/24(01:00)
2015,01,23,93201,92004,73957,18047,24.4,2015/01/23(10:00)
2015,01,22,93201,91587,73723,17864,24.2,2015/01/22(10:00)
2015,01,21,93201,91461,75544,15917,21.1,2015/01/21(11:00)
2015,01,20,93201,90433,76235,14198,18.6,2015/01/20(10:00)
2015,01,19,93201,90027,74564,15463,20.7,2015/01/19(11:00)
2015,01,18,93201,88913,62801,26112,41.6,2015/01/18(01:00)
2015,01,17,93201,88861,66531,22330,33.6,2015/01/17(11:00)
2015,01,16,92825,90210,75615,14595,19.3,2015/01/16(11:00)
2015,01,15,92825,90144,74662,15482,20.7,2015/01/15(10:00)
2015,01,14,92825,90287,76363,13924,18.2,2015/01/14(11:00)
2015,01,13,92825,91019,77150,13869,18,2015/01/13(10:00)
2015,01,12,92825,89953,76899,13054,17,2015/01/12(10:00)
2015,01,11,92825,88542,62260,26282,42.2,2015/01/11(11:00)
2015,01,10,92825,90179,66147,24032,36.3,2015/01/10(01:00)
2015,01,09,92825,90631,77107,13524,17.5,2015/01/09(11:00)
2015,01,08,92825,90501,77796,12705,16.3,2015/01/08(10:00)
2015,01,07,92825,90603,77597,13006,16.8,2015/01/07(10:00)
2015,01,06,92825,90377,74547,15830,21.2,2015/01/06(10:00)
2015,01,05,92825,89735,75118,14617,19.5,2015/01/05(11:00)
2015,01,04,92825,89554,61203,28351,46.3,2015/01/04(24:00)
2015,01,03,92825,89309,64079,25230,39.4,2015/01/03(11:00)
2015,01,02,92825,88904,69797,19107,27.4,2015/01/02(11:00)
2015,01,01,92825,87437,61739,25698,41.6,2015/01/01(24:00)
2014,12,31,93216,88465,71745,16720,23.3,2014/12/31(11:00)
2014,12,30,93216,87982,72542,15440,21.3,2014/12/30(10:00)
2014,12,29,93216,89334,74198,15136,20.4,2014/12/29(10:00)
2014,12,28,93216,88205,61769,26436,42.8,2014/12/28(01:00)
2014,12,27,93216,87776,65458,22318,34.1,2014/12/27(11:00)
2014,12,26,93216,88766,74911,13855,18.5,2014/12/26(10:00)
2014,12,25,93216,87476,65667,21809,33.2,2014/12/25(24:00)
2014,12,24,93216,89319,74969,14350,19.1,2014/12/24(10:00)
2014,12,23,93216,89306,77981,11325,14.5,2014/12/23(10:00)
2014,12,22,93216,90161,79156,11005,13.9,2014/12/22(11:00)
2014,12,21,93216,88419,64686,23733,36.7,2014/12/21(24:00)
2014,12,20,93216,87178,67176,20002,29.8,2014/12/20(11:00)
2014,12,19,93216,88662,79619,9043,11.4,2014/12/19(11:00)
2014,12,18,93216,90417,78892,11525,14.6,2014/12/18(11:00)
2014,12,17,93216,89357,80154,9203,11.5,2014/12/17(11:00)
2014,12,16,93216,88901,77950,10951,14,2014/12/16(18:00)
2014,12,15,93216,87284,77587,9697,12.5,2014/12/15(11:00)
2014,12,14,93216,86390,63231,23159,36.6,2014/12/14(01:00)
2014,12,13,93216,85732,66955,18777,28,2014/12/13(11:00)
2014,12,12,93216,86712,76682,10030,13.1,2014/12/12(10:00)
2014,12,11,93216,83959,74831,9128,12.2,2014/12/11(18:00)
2014,12,10,93216,83611,75726,7885,10.4,2014/12/10(10:00)
2014,12,09,93216,83546,76994,6552,8.5,2014/12/09(10:00)
2014,12,08,92845,83930,75976,7954,10.5,2014/12/08(11:00)
2014,12,07,92845,84502,62896,21606,34.4,2014/12/07(01:00)
2014,12,06,92845,85981,67124,18857,28.1,2014/12/06(01:00)
2014,12,05,92845,85235,75608,9627,12.7,2014/12/05(10:00)
2014,12,04,92845,84674,74965,9709,13,2014/12/04(11:00)
2014,12,03,92845,83524,74641,8883,11.9,2014/12/03(11:00)
2014,12,02,92845,83143,74227,8916,12,2014/12/02(18:00)
2014,12,01,92845,82383,72007,10376,14.4,2014/12/01(11:00)
2014,11,30,92845,81337,55881,25456,45.6,2014/11/30(23:00)
2014,11,29,92845,80153,58884,21269,36.1,2014/11/29(11:00)
2014,11,28,92845,80681,68433,12248,17.9,2014/11/28(11:00)
2014,11,27,92845,80577,67129,13448,20,2014/11/27(10:00)
2014,11,26,92845,81043,67069,13974,20.8,2014/11/26(10:00)
2014,11,25,92845,80149,67793,12356,18.2,2014/11/25(10:00)
2014,11,24,92845,79370,68325,11045,16.2,2014/11/24(01:00)
2014,11,23,92845,77872,56032,21840,39,2014/11/23(23:00)
2014,11,22,92845,78919,59676,19243,32.2,2014/11/22(11:00)
2014,11,21,92845,79519,67839,11680,17.2,2014/11/21(10:00)
2014,11,20,92845,79120,67975,11145,16.4,2014/11/20(10:00)
2014,11,19,92845,77899,69334,8565,12.4,2014/11/19(10:00)
2014,11,18,92845,78007,68121,9886,14.5,2014/11/18(10:00)
2014,11,17,92845,77438,67858,9580,14.1,2014/11/17(18:00)
2014,11,16,92845,77244,56052,21192,37.8,2014/11/16(23:00)
2014,11,15,92845,77458,60196,17262,28.7,2014/11/15(11:00)
2014,11,14,92845,80825,68655,12170,17.7,2014/11/14(10:00)
2014,11,13,92845,81184,69007,12177,17.6,2014/11/13(19:00)
2014,11,12,92845,81418,65941,15477,23.5,2014/11/12(19:00)
2014,11,11,92845,81339,64580,16759,26,2014/11/11(19:00)
2014,11,10,92845,79997,64539,15458,24,2014/11/10(19:00)
2014,11,09,92845,78554,54438,24116,44.3,2014/11/09(23:00)
2014,11,08,92845,79887,57532,22355,38.9,2014/11/08(11:00)
2014,11,07,92845,80844,63578,17266,27.2,2014/11/07(19:00)
2014,11,06,92094,80241,64014,16227,25.3,2014/11/06(19:00)
2014,11,05,92094,79874,63214,16660,26.4,2014/11/05(19:00)
2014,11,04,91196,78619,64057,14562,22.7,2014/11/04(19:00)
2014,11,03,91196,79110,63871,15239,23.9,2014/11/03(19:00)
2014,11,02,91196,78786,53691,25095,46.7,2014/11/02(23:00)
2014,11,01,91196,77622,56233,21389,38,2014/11/01(11:00)
2014,10,31,91196,77927,64278,13649,21.2,2014/10/31(11:00)
2014,10,30,91196,78731,64653,14078,21.8,2014/10/30(19:00)
2014,10,29,91196,78541,63902,14639,22.9,2014/10/29(19:00)
2014,10,28,91196,78754,64811,13943,21.5,2014/10/28(19:00)
2014,10,27,91196,77901,64128,13773,21.5,2014/10/27(19:00)
2014,10,26,91196,73546,53111,20435,38.5,2014/10/26(19:00)
2014,10,25,91196,73521,56092,17429,31.1,2014/10/25(11:00)
2014,10,24,91196,73478,63436,10042,15.8,2014/10/24(19:00)
2014,10,23,91196,75766,64120,11646,18.2,2014/10/23(19:00)
2014,10,22,91196,75905,63487,12418,19.6,2014/10/22(19:00)
2014,10,21,91196,76124,64634,11490,17.8,2014/10/21(19:00)
2014,10,20,90589,75520,64184,11336,17.7,2014/10/20(19:00)
2014,10,19,90589,74467,53074,21393,40.3,2014/10/19(20:00)
2014,10,18,90589,74637,55517,19120,34.4,2014/10/18(20:00)
2014,10,17,90589,75242,62550,12692,20.3,2014/10/17(19:00)
2014,10,16,90589,75304,63575,11729,18.4,2014/10/16(19:00)
2014,10,15,90589,74299,62626,11673,18.6,2014/10/15(19:00)
2014,10,14,90589,74374,63399,10975,17.3,2014/10/14(19:00)
2014,10,13,90589,73997,63509,10488,16.5,2014/10/13(19:00)
2014,10,12,90589,73988,52890,21098,39.9,2014/10/12(20:00)
2014,10,11,90589,73189,54877,18312,33.4,2014/10/11(19:00)
2014,10,10,90589,74379,62372,12007,19.3,2014/10/10(19:00)
2014,10,09,90589,75915,59045,16870,28.6,2014/10/09(19:00)
2014,10,08,90589,75745,61945,13800,22.3,2014/10/08(19:00)
2014,10,07,90589,75903,63184,12719,20.1,2014/10/07(19:00)
2014,10,06,90589,74429,62404,12025,19.3,2014/10/06(19:00)
2014,10,05,90589,74883,51715,23168,44.8,2014/10/05(20:00)
2014,10,04,90204,73092,53248,19844,37.3,2014/10/04(20:00)
2014,10,03,90204,74473,56747,17726,31.2,2014/10/03(20:00)
2014,10,02,90204,77070,62948,14122,22.4,2014/10/02(17:00)
2014,10,01,90204,76072,62630,13442,21.5,2014/10/01(17:00)
2014,09,30,90204,77174,63847,13327,20.9,2014/09/30(15:00)
2014,09,29,90204,75933,65058,10875,16.7,2014/09/29(15:00)
2014,09,28,90204,74242,54241,20001,36.9,2014/09/28(20:00)
2014,09,27,90204,73932,57263,16669,29.1,2014/09/27(15:00)
2014,09,26,90204,75528,64274,11254,17.5,2014/09/26(17:00)
2014,09,25,90204,76389,65682,10707,16.3,2014/09/25(17:00)
2014,09,24,90204,77455,64878,12577,19.4,2014/09/24(12:00)
2014,09,23,90204,77689,65404,12285,18.8,2014/09/23(15:00)
2014,09,22,90204,77752,65691,12061,18.4,2014/09/22(15:00)
2014,09,21,90204,74506,53797,20709,38.5,2014/09/21(20:00)
2014,09,20,90204,73655,57366,16289,28.4,2014/09/20(12:00)
2014,09,19,90204,77286,64544,12742,19.7,2014/09/19(15:00)
2014,09,18,90204,77788,64944,12844,19.8,2014/09/18(17:00)
2014,09,17,90204,78500,65050,13450,20.7,2014/09/17(15:00)
2014,09,16,90204,78001,66507,11494,17.3,2014/09/16(15:00)
2014,09,15,90204,77018,66972,10046,15,2014/09/15(17:00)
2014,09,14,90204,71949,55020,16929,30.8,2014/09/14(20:00)
2014,09,13,90204,72761,59351,13410,22.6,2014/09/13(15:00)
2014,09,12,90204,76704,65955,10749,16.3,2014/09/12(15:00)
2014,09,11,90204,77387,65262,12125,18.6,2014/09/11(17:00)
2014,09,10,90204,75569,54015,21554,39.9,2014/09/10(20:00)
2014,09,09,90204,74859,47665,27194,57.1,2014/09/09(20:00)
2014,09,08,90204,75957,44934,31023,69,2014/09/08(01:00)
2014,09,07,90204,76320,48762,27558,56.5,2014/09/07(20:00)
2014,09,06,90204,76176,55141,21035,38.1,2014/09/06(12:00)
2014,09,05,90204,81126,67144,13982,20.8,2014/09/05(15:00)
2014,09,04,90204,80684,68156,12528,18.4,2014/09/04(15:00)
2014,09,03,90204,80541,67408,13133,19.5,2014/09/03(15:00)
2014,09,02,90204,80519,67961,12558,18.5,2014/09/02(15:00)
2014,09,01,90204,81039,69406,11633,16.8,2014/09/01(15:00)
2014,08,31,90160,81746,55541,26205,47.2,2014/08/31(20:00)
2014,08,30,90160,79190,60855,18335,30.1,2014/08/30(15:00)
2014,08,29,90160,80945,68468,12477,18.2,2014/08/29(15:00)
2014,08,28,90160,81265,68404,12861,18.8,2014/08/28(15:00)
2014,08,27,90160,82142,68670,13472,19.6,2014/08/27(15:00)
2014,08,26,90160,82142,70689,11453,16.2,2014/08/26(01:00)
2014,08,25,90160,82934,69048,13886,20.1,2014/08/25(15:00)
2014,08,24,90160,80701,57285,23416,40.9,2014/08/24(20:00)
2014,08,23,90160,80035,62159,17876,28.8,2014/08/23(15:00)
2014,08,22,90160,83545,68320,15225,22.3,2014/08/22(01:00)
2014,08,21,90160,83984,68283,15701,23,2014/08/21(15:00)
2014,08,20,90160,83693,68596,15097,22,2014/08/20(15:00)
2014,08,19,90160,84008,67191,16817,25,2014/08/19(15:00)
2014,08,18,90160,83970,66232,17738,26.8,2014/08/18(15:00)
2014,08,17,90160,82577,55046,27531,50,2014/08/17(21:00)
2014,08,16,90160,81026,59837,21189,35.4,2014/08/16(15:00)
2014,08,15,90160,81731,61600,20131,32.7,2014/08/15(01:00)
2014,08,14,90160,84182,65015,19167,29.5,2014/08/14(11:00)
2014,08,13,90160,83327,68662,14665,21.4,2014/08/13(15:00)
2014,08,12,90160,83328,69977,13351,19.1,2014/08/12(15:00)
2014,08,11,90160,83859,67540,16319,24.2,2014/08/11(15:00)
2014,08,10,90160,82217,54596,27621,50.6,2014/08/10(21:00)
2014,08,09,90160,81685,59207,22478,38,2014/08/09(15:00)
2014,08,08,89435,83763,64948,18815,29,2014/08/08(15:00)
2014,08,07,89435,84813,64831,19982,30.8,2014/08/07(15:00)
2014,08,06,89435,83022,66074,16948,25.7,2014/08/06(15:00)
2014,08,05,89435,83404,65788,17616,26.8,2014/08/05(15:00)
2014,08,04,89435,82811,62294,20517,32.9,2014/08/04(15:00)
2014,08,03,89435,80592,57167,23425,41,2014/08/03(21:00)
2014,08,02,89435,80628,60964,19664,32.3,2014/08/02(12:00)
2014,08,01,89435,82655,68690,13965,20.3,2014/08/01(15:00)
2014,07,31,89435,83020,72870,10150,13.9,2014/07/31(15:00)
2014,07,30,89435,83387,72841,10546,14.5,2014/07/30(15:00)
2014,07,29,89059,84000,70243,13757,19.6,2014/07/29(15:00)
2014,07,28,88673,83501,70263,13238,18.8,2014/07/28(15:00)
2014,07,27,88673,81974,57555,24419,42.4,2014/07/27(21:00)
2014,07,26,88673,80516,63452,17064,26.9,2014/07/26(12:00)
2014,07,25,88673,84128,76054,8074,10.6,2014/07/25(15:00)
2014,07,24,88673,83670,71947,11723,16.3,2014/07/24(15:00)
2014,07,23,88673,83781,71830,11951,16.6,2014/07/23(15:00)
2014,07,22,88673,83240,73590,9650,13.1,2014/07/22(15:00)
2014,07,21,88673,82908,74839,8069,10.8,2014/07/21(15:00)
2014,07,20,88673,81360,60592,20768,34.3,2014/07/20(21:00)
2014,07,19,88673,79252,65090,14162,21.8,2014/07/19(15:00)
2014,07,18,88673,79212,71605,7607,10.6,2014/07/18(15:00)
2014,07,17,88673,80148,71498,8650,12.1,2014/07/17(15:00)
2014,07,16,88673,80324,72607,7717,10.6,2014/07/16(15:00)
2014,07,15,88673,80307,72611,7696,10.6,2014/07/15(15:00)
2014,07,14,88673,79828,72580,7248,10,2014/07/14(15:00)
2014,07,13,88673,77713,57026,20687,36.3,2014/07/13(21:00)
2014,07,12,88673,77808,63830,13978,21.9,2014/07/12(12:00)
2014,07,11,88673,79870,72310,7560,10.5,2014/07/11(15:00)
2014,07,10,88673,79522,73566,5956,8.1,2014/07/10(15:00)
2014,07,09,88673,78659,72676,5983,8.2,2014/07/09(12:00)
2014,07,08,88673,78164,70523,7641,10.8,2014/07/08(15:00)
2014,07,07,88673,77856,69831,8025,11.5,2014/07/07(15:00)
2014,07,06,88673,76422,54855,21567,39.3,2014/07/06(21:00)
2014,07,05,88673,75174,61356,13818,22.5,2014/07/05(12:00)
2014,07,04,88673,77939,68944,8995,13,2014/07/04(15:00)
2014,07,03,88673,78330,66535,11795,17.7,2014/07/03(15:00)
2014,07,02,88673,78077,70518,7559,10.7,2014/07/02(01:00)
2014,07,01,88673,77598,71029,6569,9.2,2014/07/01(15:00)
2014,06,30,87948,76831,69801,7030,10.1,2014/06/30(15:00)
2014,06,29,87948,75383,53964,21419,39.7,2014/06/29(21:00)
2014,06,28,87948,76353,61010,15343,25.1,2014/06/28(12:00)
2014,06,27,87948,77195,68262,8933,13.1,2014/06/27(17:00)
2014,06,26,87948,76473,68774,7699,11.2,2014/06/26(15:00)
2014,06,25,88148,76691,67542,9149,13.5,2014/06/25(15:00)
2014,06,24,88148,76698,66595,10103,15.2,2014/06/24(15:00)
2014,06,23,88148,76499,65547,10952,16.7,2014/06/23(15:00)
2014,06,22,88148,74946,53722,21224,39.5,2014/06/22(21:00)
2014,06,21,88148,75142,59988,15154,25.3,2014/06/21(12:00)
2014,06,20,88148,76953,67428,9525,14.1,2014/06/20(15:00)
2014,06,19,88148,76229,66800,9429,14.1,2014/06/19(15:00)
2014,06,18,88148,76405,67769,8636,12.7,2014/06/18(15:00)
2014,06,17,88548,75097,67326,7771,11.5,2014/06/17(15:00)
2014,06,16,88548,75244,66777,8467,12.7,2014/06/16(15:00)
2014,06,15,88548,74752,53962,20790,38.5,2014/06/15(21:00)
2014,06,14,88548,73253,58813,14440,24.6,2014/06/14(15:00)
2014,06,13,88548,75265,64400,10865,16.9,2014/06/13(15:00)
2014,06,12,88548,74225,64857,9368,14.4,2014/06/12(01:00)
2014,06,11,88548,74426,65006,9420,14.5,2014/06/11(15:00)
2014,06,10,87678,74552,66163,8389,12.7,2014/06/10(15:00)
2014,06,09,87678,75037,64907,10130,15.6,2014/06/09(15:00)
2014,06,08,87678,76689,52889,23800,45,2014/06/08(21:00)
2014,06,07,87678,73980,55666,18314,32.9,2014/06/07(15:00)
2014,06,06,87678,74970,58717,16253,27.7,2014/06/06(15:00)
2014,06,05,87678,75429,63187,12242,19.4,2014/06/05(15:00)
2014,06,04,87678,75459,61469,13990,22.8,2014/06/04(15:00)
2014,06,03,87678,74866,63465,11401,18,2014/06/03(15:00)
2014,06,02,87678,74289,64375,9914,15.4,2014/06/02(15:00)
2014,06,01,87678,73694,54570,19124,35,2014/06/01(21:00)
2014,05,31,87678,73356,60914,12442,20.4,2014/05/31(15:00)
2014,05,30,87678,74574,67424,7150,10.6,2014/05/30(15:00)
2014,05,29,87678,73156,66574,6582,9.9,2014/05/29(15:00)
2014,05,28,87678,73308,65865,7443,11.3,2014/05/28(01:00)
2014,05,27,87678,73310,64420,8890,13.8,2014/05/27(15:00)
2014,05,26,87678,73536,62708,10828,17.3,2014/05/26(17:00)
2014,05,25,87678,71114,52266,18848,36.1,2014/05/25(21:00)
2014,05,24,87678,67744,57838,9906,17.1,2014/05/24(15:00)
2014,05,23,87678,71512,63549,7963,12.5,2014/05/23(15:00)
2014,05,22,87678,71337,63560,7777,12.2,2014/05/22(17:00)
2014,05,21,87678,70695,62891,7804,12.4,2014/05/21(15:00)
2014,05,20,87678,70290,63090,7200,11.4,2014/05/20(15:00)
2014,05,19,87678,70761,62956,7805,12.4,2014/05/19(15:00)
2014,05,18,87678,69870,52446,17424,33.2,2014/05/18(21:00)
2014,05,17,87678,68032,56689,11343,20,2014/05/17(12:00)
2014,05,16,87678,69387,62471,6916,11.1,2014/05/16(15:00)
2014,05,15,87678,70522,62172,8350,13.4,2014/05/15(15:00)
2014,05,14,87678,69924,62471,7453,11.9,2014/05/14(15:00)
2014,05,13,87678,69385,62149,7236,11.6,2014/05/13(15:00)
2014,05,12,87678,69748,61216,8532,13.9,2014/05/12(15:00)
2014,05,11,87678,69755,52256,17499,33.5,2014/05/11(21:00)
2014,05,10,87678,68533,56582,11951,21.1,2014/05/10(01:00)
2014,05,09,88178,71606,60847,10759,17.7,2014/05/09(11:00)
2014,05,08,88178,72289,61820,10469,16.9,2014/05/08(11:00)
2014,05,07,88178,71722,59921,11801,19.7,2014/05/07(11:00)
2014,05,06,88178,70689,54460,16229,29.8,2014/05/06(01:00)
2014,05,05,88178,70742,52425,18317,34.9,2014/05/05(23:00)
2014,05,04,88178,70935,50506,20429,40.4,2014/05/04(23:00)
2014,05,03,88178,71128,52592,18536,35.2,2014/05/03(12:00)
2014,05,02,88178,72112,58473,13639,23.3,2014/05/02(01:00)
2014,05,01,88178,72950,55782,17168,30.8,2014/05/01(21:00)
2014,04,30,88178,73723,61294,12429,20.3,2014/04/30(15:00)
2014,04,29,88178,72233,62173,10060,16.2,2014/04/29(11:00)
2014,04,28,87858,72139,62596,9543,15.2,2014/04/28(15:00)
2014,04,27,87858,71031,52100,18931,36.3,2014/04/27(21:00)
2014,04,26,87858,69522,55806,13716,24.6,2014/04/26(11:00)
2014,04,25,87858,71743,61166,10577,17.3,2014/04/25(17:00)
2014,04,24,87858,72445,61456,10989,17.9,2014/04/24(20:00)
2014,04,23,87858,71889,60966,10923,17.9,2014/04/23(11:00)
2014,04,22,87858,72185,61699,10486,17,2014/04/22(20:00)
2014,04,21,87858,72156,61312,10844,17.7,2014/04/21(20:00)
2014,04,20,87855,70491,52591,17900,34,2014/04/20(21:00)
2014,04,19,87858,69979,57447,12532,21.8,2014/04/19(11:00)
2014,04,18,87858,71494,62898,8596,13.7,2014/04/18(11:00)
2014,04,17,87858,71273,63069,8204,13,2014/04/17(20:00)
2014,04,16,87858,69961,61956,8005,12.9,2014/04/16(15:00)
2014,04,15,87858,70166,62333,7833,12.6,2014/04/15(20:00)
2014,04,14,87858,71237,62272,8965,14.4,2014/04/14(20:00)
2014,04,13,87858,69789,53026,16763,31.6,2014/04/13(23:00)
2014,04,12,87858,69594,57820,11774,20.4,2014/04/12(11:00)
2014,04,11,87858,71742,63314,8428,13.3,2014/04/11(10:00)
2014,04,10,87858,71008,63345,7663,12.1,2014/04/10(10:00)
2014,04,09,87858,71458,63343,8115,12.8,2014/04/09(10:00)
2014,04,08,87334,70766,63010,7756,12.3,2014/04/08(20:00)
2014,04,07,87334,71203,63722,7481,11.7,2014/04/07(11:00)
2014,04,06,87334,71203,54598,16605,30.4,2014/04/06(23:00)
2014,04,05,87334,71860,57527,14333,24.9,2014/04/05(11:00)
2014,04,04,87334,71291,63757,7534,11.8,2014/04/04(11:00)
2014,04,03,87334,71900,63504,8396,13.2,2014/04/03(20:00)
2014,04,02,87734,70845,61890,8955,14.5,2014/04/02(10:00)
2014,04,01,87171,71756,62418,9338,15,2014/04/01(20:00)
2014,03,31,87177,71728,62487,9241,14.8,2014/03/31(11:00)
2014,03,30,87177,70630,53354,17276,32.4,2014/03/30(23:00)
2014,03,29,87171,72425,58164,14261,24.5,2014/03/29(11:00)
2014,03,28,87171,75753,62413,13340,21.4,2014/03/28(10:00)
2014,03,27,87171,76132,64011,12121,18.9,2014/03/27(10:00)
2014,03,26,87171,75610,64149,11461,17.9,2014/03/26(11:00)
2014,03,25,87171,76370,64482,11888,18.4,2014/03/25(11:00)
2014,03,24,87171,75622,64545,11077,17.2,2014/03/24(10:00)
2014,03,23,87171,74272,55419,18853,34,2014/03/23(01:00)
2014,03,22,87171,73432,59838,13594,22.7,2014/03/22(11:00)
2014,03,21,87171,76106,67809,8297,12.2,2014/03/21(10:00)
2014,03,20,87171,76095,67400,8695,12.9,2014/03/20(10:00)
2014,03,19,87171,75232,66737,8495,12.7,2014/03/19(11:00)
2014,03,18,87171,74496,65543,8953,13.7,2014/03/18(10:00)
2014,03,17,87171,74736,65809,8927,13.6,2014/03/17(10:00)
2014,03,16,87171,71711,55703,16008,28.7,2014/03/16(01:00)
2014,03,15,87171,70657,61734,8923,14.5,2014/03/15(11:00)
2014,03,14,87171,76111,68928,7183,10.4,2014/03/14(10:00)
2014,03,13,87171,76505,70934,5571,7.9,2014/03/13(10:00)
2014,03,12,87171,76527,70836,5691,8,2014/03/12(11:00)
2014,03,11,87171,77020,70922,6098,8.6,2014/03/11(10:00)
2014,03,10,87171,77100,71629,5471,7.6,2014/03/10(11:00)
2014,03,09,87171,75415,58998,16417,27.8,2014/03/09(24:00)
2014,03,08,87171,73455,63537,9918,15.6,2014/03/08(11:00)
2014,03,07,87171,78016,72167,5849,8.1,2014/03/07(10:00)
2014,03,06,87171,77322,71384,5938,8.3,2014/03/06(10:00)
2014,03,05,87171,76534,70162,6372,9.1,2014/03/05(10:00)
2014,03,04,87171,76876,69932,6944,9.9,2014/03/04(10:00)
2014,03,03,87171,76084,68575,7509,11,2014/03/03(10:00)
2014,03,02,87171,74695,56807,17888,31.5,2014/03/02(23:00)
2014,03,01,87171,74148,58850,15298,26,2014/03/01(23:00)
2014,02,28,87171,76274,67179,9095,13.5,2014/02/28(10:00)
2014,02,27,87171,75749,67342,8407,12.5,2014/02/27(10:00)
2014,02,26,87171,75725,69420,6305,9.1,2014/02/26(10:00)
2014,02,25,87171,76019,69583,6436,9.2,2014/02/25(10:00)
2014,02,24,87171,78232,69972,8260,11.8,2014/02/24(10:00)
2014,02,23,87171,77864,58631,19233,32.8,2014/02/23(01:00)
2014,02,22,87171,77296,62750,14546,23.2,2014/02/22(11:00)
2014,02,21,87171,79834,71428,8406,11.8,2014/02/21(10:00)
2014,02,20,87171,79510,71641,7869,11,2014/02/20(10:00)
2014,02,19,87171,80515,71872,8643,12,2014/02/19(10:00)
2014,02,18,87171,80300,71120,9180,12.9,2014/02/18(10:00)
2014,02,17,87171,80146,70900,9246,13,2014/02/17(10:00)
2014,02,16,87171,79288,58797,20491,34.9,2014/02/16(01:00)
2014,02,15,87171,79036,62944,16092,25.6,2014/02/15(11:00)
2014,02,14,87171,81774,72398,9376,13,2014/02/14(10:00)
2014,02,13,87171,81472,73371,8101,11,2014/02/13(10:00)
2014,02,12,87171,82049,73302,8747,11.9,2014/02/12(10:00)
2014,02,11,87171,82337,73982,8355,11.3,2014/02/11(10:00)
2014,02,10,87171,82249,74404,7845,10.5,2014/02/10(11:00)
2014,02,09,87171,81858,60604,21254,35.1,2014/02/09(24:00)
2014,02,08,87171,79368,65220,14148,21.7,2014/02/08(11:00)
2014,02,07,871711,81921,74297,7624,10.3,2014/02/07(10:00)
2014,02,06,87171,82873,76274,6599,8.7,2014/02/06(10:00)
2014,02,05,87171,83333,77295,6038,7.8,2014/02/05(10:00)
2014,02,04,87171,83238,75443,7795,10.3,2014/02/04(11:00)
2014,02,03,87171,81736,68620,13116,19.1,2014/02/03(01:00)
2014,02,02,87171,79950,53374,26576,49.8,2014/02/02(24:00)
2014,02,01,87171,78634,51521,27113,52.6,2014/02/01(24:00)
2014,01,31,87171,80632,51068,29564,57.9,2014/01/31(24:00)
2014,01,30,87171,81281,56440,24841,44,2014/01/30(01:00)
2014,01,29,87171,82244,69659,12585,18.1,2014/01/29(10:00)
2014,01,28,87171,83139,71539,11600,16.2,2014/01/28(10:00)
2014,01,27,87177,83213,73444,9769,13.3,2014/01/27(10:00)
2014,01,26,86969,81313,61182,20131,32.9,2014/01/26(24:00)
2014,01,25,86969,79201,64359,14842,23.1,2014/01/25(11:00)
2014,01,24,86969,82780,73391,9389,12.8,2014/01/24(10:00)
2014,01,23,86969,83135,75362,7773,10.3,2014/01/23(10:00)
2014,01,22,86969,84077,76306,7771,10.2,2014/01/22(10:00)
2014,01,21,86969,84080,76751,7329,9.5,2014/01/21(11:00)
2014,01,20,86969,83514,75282,8232,10.9,2014/01/20(11:00)
2014,01,19,86969,82786,62682,20104,32.1,2014/01/19(01:00)
2014,01,18,86969,82802,66275,16527,24.9,2014/01/18(11:00)
2014,01,17,86969,83911,75359,8552,11.3,2014/01/17(10:00)
2014,01,16,86969,82300,75473,6827,9,2014/01/16(11:00)
2014,01,15,86969,83690,75939,7751,10.2,2014/01/15(10:00)
2014,01,14,86969,83755,76442,7313,9.6,2014/01/14(10:00)
2014,01,13,86969,83484,76173,7311,9.6,2014/01/13(11:00)
2014,01,12,86969,83318,62125,21193,34.1,2014/01/12(24:00)
2014,01,11,86969,80527,65783,14744,22.4,2014/01/11(11:00)
2014,01,10,86969,82348,76389,5959,7.8,2014/01/10(11:00)
2014,01,09,86969,82525,75555,6970,9.2,2014/01/09(10:00)
2014,01,08,86969,82226,73029,9197,12.6,2014/01/08(11:00)
2014,01,07,86969,82224,73338,8886,12.1,2014/01/07(10:00)
2014,01,06,86969,81904,72948,8956,12.3,2014/01/06(10:00)
2014,01,05,86969,80595,59580,21015,35.3,2014/01/05(24:00)
2014,01,04,86969,79898,62599,17299,27.6,2014/01/04(11:00)
2014,01,03,86969,81239,71195,10044,14.1,2014/01/03(10:00)
2014,01,02,86969,81121,68868,12253,17.8,2014/01/02(11:00)
2014,01,01,86969,80957,57526,23431,40.7,2014/01/01(01:00)
2013,12,31,86969,81536,67916,13620,20.1,2013/12/31(10:00)
2013,12,30,86969,81472,71415,10057,14.1,2013/12/30(11:00)
2013,12,29,86969,80266,61896,18370,29.7,2013/12/29(01:00)
2013,12,28,86969,79283,65478,13805,21.1,2013/12/28(11:00)
2013,12,27,86969,81129,74675,6454,8.6,2013/12/27(11:00)
2013,12,26,86969,80779,73961,6818,9.2,2013/12/26(11:00)
2013,12,25,86969,80803,63668,17135,26.9,2013/12/25(01:00)
2013,12,24,86969,80597,74501,6096,8.2,2013/12/24(10:00)
2013,12,23,86969,81008,73629,7379,10,2013/12/23(11:00)
2013,12,22,86969,79413,61367,18046,29.4,2013/12/22(01:00)
2013,12,21,86969,78851,65438,13413,20.5,2013/12/21(11:00)
2013,12,20,86969,81588,74935,6653,8.9,2013/12/20(11:00)
2013,12,19,86969,80810,74118,6692,9,2013/12/19(11:00)
2013,12,18,86969,81117,72991,8126,11.1,2013/12/18(10:00)
2013,12,17,86969,81295,75108,6187,8.2,2013/12/17(11:00)
2013,12,16,86969,81270,75681,5589,7.4,2013/12/16(11:00)
2013,12,15,86969,78766,60957,17809,29.2,2013/12/15(24:00)
2013,12,14,86969,76972,64733,12239,18.9,2013/12/14(11:00)
2013,12,13,86969,80780,73917,6863,9.3,2013/12/13(11:00)
2013,12,12,86969,81256,72898,8358,11.5,2013/12/12(10:00)
2013,12,11,86969,81996,71706,10290,14.4,2013/12/11(11:00)
2013,12,10,86969,81637,70932,10705,15.1,2013/12/10(10:00)
2013,12,09,86969,80918,71012,9906,13.9,2013/12/09(11:00)
2013,12,08,86969,76979,57802,19177,33.2,2013/12/08(01:00)
2013,12,07,86969,76325,61430,14895,24.2,2013/12/07(11:00)
2013,12,06,86969,79746,69939,9807,14,2013/12/06(10:00)
2013,12,05,86969,78674,69964,8710,12.4,2013/12/05(10:00)
2013,12,04,86969,78920,70241,8679,12.4,2013/12/04(10:00)
2013,12,03,86969,79492,69642,9850,14.1,2013/12/03(10:00)
2013,12,02,86969,78710,69941,8769,12.5,2013/12/02(11:00)
2013,12,01,86969,76293,57856,18437,31.9,2013/12/01(24:00)
2013,11,30,86969,75919,62184,13735,22.1,2013/11/30(11:00)
2013,11,29,86333,79653,72472,7181,9.9,2013/11/29(10:00)
2013,11,28,86333,78870,72686,6184,8.5,2013/11/28(10:00)
2013,11,27,86333,77168,71192,5976,8.4,2013/11/27(11:00)
2013,11,26,86333,77306,69943,7363,10.5,2013/11/26(10:00)
2013,11,25,86333,77044,69053,7991,11.6,2013/11/25(18:00)
2013,11,24,86333,74793,56221,18572,33,2013/11/24(01:00)
2013,11,23,86333,74793,57200,17593,30.8,2013/11/23(11:00)
2013,11,22,86333,76138,68915,7223,10.5,2013/11/22(10:00)
2013,11,21,86333,76001,69400,6601,9.5,2013/11/21(10:00)
2013,11,20,86333,76238,69837,6401,9.2,2013/11/20(10:00)
2013,11,19,86333,74992,69483,5509,7.9,2013/11/19(18:00)
2013,11,18,86333,74742,69316,5426,7.8,2013/11/18(18:00)
2013,11,17,86333,71737,56018,15719,28.1,2013/11/17(23:00)
2013,11,16,86333,70621,58986,11635,19.7,2013/11/16(11:00)
2013,11,15,86333,74331,65666,8665,13.2,2013/11/15(10:00)
2013,11,14,86333,73819,67082,6737,10,2013/11/14(11:00)
2013,11,13,86333,73794,66150,7644,11.6,2013/11/13(10:00)
2013,11,12,86333,74155,66426,7729,11.6,2013/11/12(19:00)
2013,11,11,86333,73963,65865,8098,12.3,2013/11/11(19:00)
2013,11,10,86333,69772,54144,15628,28.9,2013/11/10(23:00)
2013,11,09,86333,68364,55968,12396,22.1,2013/11/09(11:00)
2013,11,08,86333,72084,62796,9288,14.8,2013/11/08(19:00)
2013,11,07,86333,71593,62671,8922,14.2,2013/11/07(19:00)
2013,11,06,86333,71457,62657,8800,14,2013/11/06(17:00)
2013,11,05,86333,71136,62668,8468,13.5,2013/11/05(19:00)
2013,11,04,86333,71064,62623,8441,13.5,2013/11/04(19:00)
2013,11,03,86333,68532,52359,16173,30.9,2013/11/03(23:00)
2013,11,02,86333,67924,55557,12367,22.3,2013/11/02(12:00)
2013,11,01,86333,69404,61066,8338,13.7,2013/11/01(19:00)
2013,10,31,86333,69799,63329,6470,10.2,2013/10/31(01:00)
2013,10,30,86333,70201,62824,7377,11.7,2013/10/30(19:00)
2013,10,29,86333,70005,63926,6079,9.5,2013/10/29(19:00)
2013,10,28,86333,69356,63155,6201,9.8,2013/10/28(19:00)
2013,10,27,86333,68172,51788,16384,31.6,2013/10/27(20:00)
2013,10,26,86333,66414,54801,11613,21.2,2013/10/26(11:00)
2013,10,25,86333,70573,62398,8175,13.1,2013/10/25(19:00)
2013,10,24,86333,69665,62777,6888,11,2013/10/24(19:00)
2013,10,23,86333,68986,62185,6801,10.9,2013/10/23(19:00)
2013,10,22,86333,68757,62822,5935,9.4,2013/10/22(19:00)
2013,10,21,86333,68004,62099,5905,9.5,2013/10/21(19:00)
2013,10,20,86333,65914,51487,14427,28,2013/10/20(20:00)
2013,10,19,86333,66713,55528,11185,20.1,2013/10/19(11:00)
2013,10,18,86333,67720,61911,5809,9.4,2013/10/18(19:00)
2013,10,17,86333,68582,62394,6188,9.9,2013/10/17(19:00)
2013,10,16,86333,69098,61498,7600,12.4,2013/10/16(19:00)
2013,10,15,86333,68613,62574,6039,9.7,2013/10/15(19:00)
2013,10,14,86333,68567,62685,5882,9.4,2013/10/14(19:00)
2013,10,13,86333,66754,51494,15260,29.6,2013/10/13(20:00)
2013,10,12,86333,66960,54568,12392,22.7,2013/10/12(12:00)
2013,10,11,86333,69410,62118,7292,11.7,2013/10/11(11:00)
2013,10,10,86333,69784,64136,5648,8.8,2013/10/10(19:00)
2013,10,09,86333,68974,59766,9208,15.4,2013/10/09(15:00)
2013,10,08,86333,69879,64075,5804,9.1,2013/10/08(11:00)
2013,10,07,86136,70074,64911,5163,8,2013/10/07(19:00)
2013,10,06,86136,68695,53017,15678,29.6,2013/10/06(20:00)
2013,10,05,86136,67497,55667,11830,21.3,2013/10/05(12:00)
2013,10,04,86136,68324,61182,7142,11.7,2013/10/04(19:00)
2013,10,03,86136,68693,57222,11471,20,2013/10/03(20:00)
2013,10,02,86136,68092,62685,5407,8.6,2013/10/02(11:00)
2013,10,01,86136,68888,63532,5356,8.4,2013/10/01(19:00)
2013,09,30,86136,69875,62764,7111,11.3,2013/09/30(17:00)
2013,09,29,86136,69052,52725,16327,31,2013/09/29(20:00)
2013,09,28,86136,67081,56668,10413,18.4,2013/09/28(11:00)
2013,09,27,86136,70742,61263,9479,15.5,2013/09/27(15:00)
2013,09,26,86136,71963,61708,10255,16.6,2013/09/26(20:00)
2013,09,25,86136,72891,63041,9850,15.6,2013/09/25(15:00)
2013,09,24,86136,72355,65765,6590,10,2013/09/24(15:00)
2013,09,23,86136,71411,64919,6492,10,2013/09/23(15:00)
2013,09,22,86136,71154,52637,18517,35.2,2013/09/22(20:00)
2013,09,21,86136,71001,50913,20088,39.5,2013/09/21(20:00)
2013,09,20,86136,72540,47235,25305,53.6,2013/09/20(20:00)
2013,09,19,86136,73168,44095,29073,65.9,2013/09/19(20:00)
2013,09,18,86136,72932,47703,25229,52.9,2013/09/18(20:00)
2013,09,17,86136,77346,60397,16949,28.1,2013/09/17(12:00)
2013,09,16,86136,76219,62839,13380,21.3,2013/09/16(15:00)
2013,09,15,86136,75124,55438,19686,35.5,2013/09/15(20:00)
2013,09,14,86136,73123,61174,11949,19.5,2013/09/14(12:00)
2013,09,13,86136,76337,67689,8648,12.8,2013/09/13(15:00)
2013,09,12,86136,76263,66213,10050,15.2,2013/09/12(17:00)
2013,09,11,86136,76738,66061,10677,16.2,2013/09/11(17:00)
2013,09,10,86136,76594,65504,11090,16.9,2013/09/10(17:00)
2013,09,09,86136,75557,65106,10451,16.1,2013/09/09(15:00)
2013,09,08,86136,73747,53099,20648,38.9,2013/09/08(20:00)
2013,09,07,86136,74006,57341,16665,29.1,2013/09/07(15:00)
2013,09,06,86136,77824,62697,15127,24.1,2013/09/06(11:00)
2013,09,05,86136,77473,63323,14150,22.3,2013/09/05(15:00)
2013,09,04,86136,77502,64303,13199,20.5,2013/09/04(17:00)
2013,09,03,86136,76614,63488,13126,20.7,2013/09/03(11:00)
2013,09,02,86136,76908,65238,11670,17.9,2013/09/02(15:00)
2013,09,01,86136,73229,54172,19057,35.2,2013/09/01(20:00)
2013,08,31,86136,72611,59493,13118,22,2013/08/31(15:00)
2013,08,30,86136,75588,68095,7493,11,2013/08/30(15:00)
2013,08,29,86136,75951,69623,6328,9.1,2013/08/29(12:00)
2013,08,28,86136,76429,69475,6954,10,2013/08/28(15:00)
2013,08,27,86136,77414,69286,8128,11.7,2013/08/27(15:00)
2013,08,26,86136,77747,69003,8744,12.7,2013/08/26(15:00)
2013,08,25,86136,75963,56316,19647,34.9,2013/08/25(21:00)
2013,08,24,86136,74834,63061,11773,18.7,2013/08/24(12:00)
2013,08,23,86136,77072,70527,6545,9.3,2013/08/23(12:00)
2013,08,22,86136,77631,73657,3974,5.4,2013/08/22(15:00)
2013,08,21,86136,76982,73266,3716,5.1,2013/08/21(15:00)
2013,08,20,86136,77908,73315,4593,6.3,2013/08/20(15:00)
2013,08,19,86136,78734,74015,4719,6.4,2013/08/19(15:00)
2013,08,18,85516,76922,62710,14212,22.7,2013/08/18(21:00)
2013,08,17,85516,75968,67118,8850,13.2,2013/08/17(15:00)
2013,08,16,85516,78167,73216,4951,6.8,2013/08/16(12:00)
2013,08,15,85516,77233,69027,8206,11.9,2013/08/15(15:00)
2013,08,14,85516,77778,72501,5277,7.3,2013/08/14(12:00)
2013,08,13,85516,77039,72615,4424,6.1,2013/08/13(15:00)
2013,08,12,85516,77413,73302,4111,5.6,2013/08/12(12:00)
2013,08,11,85516,74960,62837,12123,19.3,2013/08/11(21:00)
2013,08,10,85516,75710,67476,8234,12.2,2013/08/10(12:00)
2013,08,09,85516,78046,73600,4446,6,2013/08/09(15:00)
2013,08,08,85516,78056,73819,4237,5.7,2013/08/08(17:00)
2013,08,07,85516,77831,71825,6006,8.4,2013/08/07(15:00)
2013,08,06,85516,77895,68852,9043,13.1,2013/08/06(12:00)
2013,08,05,85516,77532,67856,9676,14.3,2013/08/05(15:00)
2013,08,04,85516,74017,58813,15204,25.9,2013/08/04(21:00)
2013,08,03,85516,73083,59182,13901,23.5,2013/08/03(14:00)
2013,08,02,85516,75609,62649,12960,20.7,2013/08/02(15:00)
2013,08,01,85516,76416,63959,12457,19.5,2013/08/01(15:00)
2013,07,31,85516,77465,65764,11701,17.8,2013/07/31(15:00)
2013,07,30,85516,77429,67939,9490,14,2013/07/30(15:00)
2013,07,29,85516,77106,68634,8472,12.3,2013/07/29(15:00)
2013,07,28,85358,75479,58219,17260,29.6,2013/07/28(21:00)
2013,07,27,85358,75708,62688,13020,20.8,2013/07/27(12:00)
2013,07,26,85358,77440,70324,7116,10.1,2013/07/26(15:00)
2013,07,25,85358,77766,69868,7898,11.3,2013/07/25(15:00)
2013,07,24,85358,78156,69230,8926,12.9,2013/07/24(15:00)
2013,07,23,85358,78240,70119,8121,11.6,2013/07/23(11:00)
2013,07,22,85358,78357,71648,6709,9.4,2013/07/22(15:00)
2013,07,21,85358,74678,59289,15389,26,2013/07/21(21:00)
2013,07,20,85358,74576,64473,10103,15.7,2013/07/20(12:00)
2013,07,19,85358,76473,72112,4361,6,2013/07/19(15:00)
2013,07,18,85358,76557,71257,5300,7.4,2013/07/18(15:00)
2013,07,17,85358,76169,70143,6026,8.6,2013/07/17(15:00)
2013,07,16,85358,76548,71529,5019,7,2013/07/16(15:00)
2013,07,15,84862,76298,71101,5197,7.3,2013/07/15(15:00)
2013,07,14,84862,73490,56534,16956,30,2013/07/14(21:00)
2013,07,13,84862,72952,62633,10319,16.5,2013/07/13(12:00)
2013,07,12,84862,75197,69699,5498,7.9,2013/07/12(15:00)
2013,07,11,84862,74699,70155,4544,6.5,2013/07/11(15:00)
2013,07,10,84862,74663,69934,4729,6.8,2013/07/10(15:00)
2013,07,09,84862,74322,69627,4695,6.7,2013/07/09(15:00)
2013,07,08,84371,74535,68800,5735,8.3,2013/07/08(15:00)
2013,07,07,84371,70878,55795,15083,27,2013/07/07(21:00)
2013,07,06,84371,71257,61321,9936,16.2,2013/07/06(15:00)
2013,07,05,84371,75373,68039,7334,10.8,2013/07/05(15:00)
2013,07,04,84371,75116,69137,5979,8.6,2013/07/04(15:00)
2013,07,03,84371,75380,69222,6158,8.9,2013/07/03(15:00)
2013,07,02,84371,75086,69401,5685,8.2,2013/07/02(15:00)
2013,07,01,84371,74572,68943,5629,8.2,2013/07/01(17:00)
2013,06,30,84371,71912,55838,16074,28.8,2013/06/30(21:00)
2013,06,29,84371,71110,60959,10151,16.7,2013/06/29(15:00)
2013,06,28,83749,74174,68422,5752,8.4,2013/06/28(15:00)
2013,06,27,83749,73565,68472,5093,7.4,2013/06/27(15:00)
2013,06,26,83749,73582,67914,5668,8.3,2013/06/26(15:00)
2013,06,25,83749,73751,67878,5873,8.7,2013/06/25(15:00)
2013,06,24,83749,72501,67212,5289,7.9,2013/06/24(15:00)
2013,06,23,83749,68226,52918,15308,28.9,2013/06/23(21:00)
2013,06,22,83749,68979,60744,8235,13.6,2013/06/22(12:00)
2013,06,21,83749,71563,67030,4533,6.8,2013/06/21(12:00)
2013,06,20,83749,72028,67488,4540,6.7,2013/06/20(15:00)
2013,06,19,83749,71872,67156,4716,7,2013/06/19(17:00)
2013,06,18,83749,72031,66929,5102,7.6,2013/06/18(15:00)
2013,06,17,83749,70892,66566,4326,6.5,2013/06/17(15:00)
2013,06,16,83749,66461,53717,12744,23.7,2013/06/16(21:00)
2013,06,15,83749,67663,60427,7236,12,2013/06/15(15:00)
2013,06,14,83749,71209,66475,4734,7.1,2013/06/14(15:00)
2013,06,13,83749,71175,66272,4903,7.4,2013/06/13(15:00)
2013,06,12,83749,70426,64819,5607,8.7,2013/06/12(15:00)
2013,06,11,83749,71426,65850,5576,8.5,2013/06/11(15:00)
2013,06,10,83749,70725,66076,4649,7,2013/06/10(15:00)
2013,06,09,83749,64713,53036,11677,22,2013/06/09(21:00)
2013,06,08,83749,65731,58352,7379,12.6,2013/06/08(12:00)
2013,06,07,83749,67653,63441,4212,6.6,2013/06/07(15:00)
2013,06,06,83749,66583,60606,5977,9.9,2013/06/06(15:00)
2013,06,05,83749,68200,63384,4816,7.6,2013/06/05(15:00)
2013,06,04,83749,67392,63185,4207,6.7,2013/06/04(17:00)
2013,06,03,83749,66890,62596,4294,6.9,2013/06/03(15:00)
2013,06,02,83749,66090,51697,14393,27.8,2013/06/02(21:00)
2013,06,01,83749,64898,55168,9730,17.6,2013/06/01(12:00)
2013,05,31,83749,67329,61677,5652,9.2,2013/05/31(15:00)
2013,05,30,83749,67127,61737,5390,8.7,2013/05/30(15:00)
2013,05,29,83465,67831,62090,5741,9.2,2013/05/29(15:00)
2013,05,28,83465,68910,63029,5881,9.3,2013/05/28(15:00)
2013,05,27,83465,69104,62576,6528,10.4,2013/05/27(17:00)
2013,05,26,83465,67381,51923,15458,29.8,2013/05/26(21:00)
2013,05,25,83465,65422,57270,8152,14.2,2013/05/25(15:00)
2013,05,24,83465,67100,61928,5172,8.4,2013/05/24(15:00)
2013,05,23,83465,66527,61462,5065,8.2,2013/05/23(15:00)
2013,05,22,83465,66430,60558,5872,9.7,2013/05/22(15:00)
2013,05,21,83465,65171,59595,5576,9.4,2013/05/21(15:00)
2013,05,20,83465,65318,59795,5523,9.2,2013/05/20(11:00)
2013,05,19,83465,62765,50511,12254,24.3,2013/05/19(21:00)
2013,05,18,83465,61758,52401,9357,17.9,2013/05/18(21:00)
2013,05,17,83465,62517,54382,8135,15,2013/05/17(21:00)
2013,05,16,83465,65686,60111,5575,9.3,2013/05/16(11:00)
2013,05,15,83465,66135,61018,5117,8.4,2013/05/15(15:00)
2013,05,14,83465,66013,60873,5140,8.4,2013/05/14(17:00)
2013,05,13,83465,66246,60757,5489,9,2013/05/13(15:00)
2013,05,12,83465,64118,50776,13342,26.3,2013/05/12(21:00)
2013,05,11,83465,64747,53938,10809,20,2013/05/11(11:00)
2013,05,10,83465,66336,60692,5644,9.3,2013/05/10(11:00)
2013,05,09,83465,66088,60325,5763,9.6,2013/05/09(15:00)
2013,05,08,83465,65576,59488,6088,10.2,2013/05/08(15:00)
2013,05,07,83465,65103,59475,5628,9.5,2013/05/07(17:00)
2013,05,06,83465,65206,58827,6379,10.8,2013/05/06(21:00)
2013,05,05,83465,65175,50753,14422,28.4,2013/05/05(23:00)
2013,05,04,83465,63404,53102,10302,19.4,2013/05/04(11:00)
2013,05,03,83465,65398,59617,5781,9.7,2013/05/03(11:00)
2013,05,02,83465,65971,59465,6506,10.9,2013/05/02(20:00)
2013,05,01,83465,65950,54401,11549,21.2,2013/05/01(21:00)
2013,04,30,83465,65965,59710,6255,10.5,2013/04/30(10:00)
2013,04,29,83465,65917,60584,5333,8.8,2013/04/29(11:00)
2013,04,28,83465,63511,51398,12113,23.6,2013/04/28(23:00)
2013,04,27,83465,64207,54274,9933,18.3,2013/04/27(23:00)
2013,04,26,83465,66289,60659,5630,9.3,2013/04/26(11:00)
2013,04,25,83465,66451,61275,5176,8.4,2013/04/25(20:00)
2013,04,24,83465,65434,59889,5545,9.3,2013/04/24(20:00)
2013,04,23,83465,66528,62169,4359,7,2013/04/23(17:00)
2013,04,22,83465,66051,60892,5159,8.5,2013/04/22(11:00)
2013,04,21,83465,64851,53250,11601,21.8,2013/04/21(23:00)
2013,04,20,83465,64731,58619,6112,10.4,2013/04/20(11:00)
2013,04,19,83465,67906,61310,6596,10.8,2013/04/19(11:00)
2013,04,18,83465,67381,61499,5882,9.6,2013/04/18(11:00)
2013,04,17,83465,67742,61925,5817,9.4,2013/04/17(11:00)
2013,04,16,83295,68267,61632,6635,10.8,2013/04/16(11:00)
2013,04,15,83295,68457,63318,5139,8.1,2013/04/15(11:00)
2013,04,14,83295,66093,53790,12303,22.9,2013/04/14(23:00)
2013,04,13,83295,67062,56491,10571,18.7,2013/04/13(01:00)
2013,04,12,83295,69195,63704,5491,8.6,2013/04/12(11:00)
2013,04,11,83295,69737,64092,5645,8.8,2013/04/11(11:00)
2013,04,10,83295,69345,64054,5291,8.3,2013/04/10(11:00)
2013,04,09,83295,69454,64098,5356,8.4,2013/04/09(20:00)
2013,04,08,83295,69370,63306,6064,9.6,2013/04/08(11:00)
2013,04,07,83295,68867,54491,14376,26.4,2013/04/07(23:00)
2013,04,06,83295,68732,57295,11437,20,2013/04/06(12:00)
2013,04,05,83295,69187,60601,8586,14.2,2013/04/05(11:00)
2013,04,04,83295,69894,62740,7154,11.4,2013/04/04(10:00)
2013,04,03,83295,69889,63906,5983,9.4,2013/04/03(10:00)
2013,04,02,83295,70225,64872,5353,8.3,2013/04/02(10:00)
2013,04,01,83295,69997,63611,6386,10,2013/04/01(11:00)
2013,03,31,83295,70153,54007,16146,29.9,2013/03/31(23:00)
2013,03,30,83295,68269,56973,11296,19.8,2013/03/30(11:00)
2013,03,29,83295,71644,63768,7876,12.4,2013/03/29(10:00)
2013,03,28,83295,71507,63891,7616,11.9,2013/03/28(10:00)
2013,03,27,83295,71498,64627,6871,10.6,2013/03/27(10:00)
2013,03,26,83295,72349,66106,6243,9.4,2013/03/26(10:00)
2013,03,25,83295,72352,65718,6634,10.1,2013/03/25(11:00)
2013,03,24,83295,71357,54589,16768,30.7,2013/03/24(23:00)
2013,03,23,83295,69949,58514,11435,19.5,2013/03/23(11:00)
2013,03,22,83295,74743,66964,7779,11.6,2013/03/22(11:00)
2013,03,21,82520,74117,67159,6958,10.4,2013/03/21(10:00)
2013,03,20,82520,73897,65952,7945,12,2013/03/20(11:00)
2013,03,19,82520,73645,64275,9370,14.6,2013/03/19(10:00)
2013,03,18,82250,73647,64038,9609,15,2013/03/18(11:00)
2013,03,17,82520,69967,54585,15382,28.2,2013/03/17(23:00)
2013,03,16,82520,71062,58869,12193,20.7,2013/03/16(11:00)
2013,03,15,82520,74939,66752,8187,12.3,2013/03/15(10:00)
2013,03,14,82520,74976,66346,8630,13,2013/03/14(10:00)
2013,03,13,82520,74637,66668,7969,12,2013/03/13(11:00)
2013,03,12,82520,74563,66052,8511,12.9,2013/03/12(10:00)
2013,03,11,82520,74917,66073,8844,13.4,2013/03/11(11:00)
2013,03,10,82520,72899,55328,17571,31.8,2013/03/10(23:00)
2013,03,09,82520,72301,57125,15176,26.6,2013/03/09(11:00)
2013,03,08,82520,75458,66335,9123,13.8,2013/03/08(10:00)
2013,03,07,82520,75324,66035,9289,14.1,2013/03/07(11:00)
2013,03,06,82520,75894,68551,7343,10.7,2013/03/06(10:00)
2013,03,05,82520,76074,69252,6822,9.9,2013/03/05(10:00)
2013,03,04,82520,76523,69653,6870,9.9,2013/03/04(11:00)
2013,03,03,82520,73966,57568,16398,28.5,2013/03/03(23:00)
2013,03,02,82520,73991,60144,13847,23,2013/03/02(24:00)
2013,03,01,82520,74147,61639,12508,20.3,2013/03/01(24:00)
2013,02,28,82296,75904,66378,9526,14.4,2013/02/28(10:00)
2013,02,27,82296,76114,66919,9195,13.7,2013/02/27(10:00)
2013,02,26,82296,76725,69758,6967,10,2013/02/26(11:00)
2013,02,25,82296,76806,69513,7293,10.5,2013/02/25(11:00)
2013,02,24,82296,75013,59503,15510,26.1,2013/02/24(01:00)
2013,02,23,82296,74790,62773,12017,19.1,2013/02/23(11:00)
2013,02,22,82296,77225,70240,6985,9.9,2013/02/22(10:00)
2013,02,21,82296,77022,71294,5728,8,2013/02/21(10:00)
2013,02,20,82296,77534,71826,5708,7.9,2013/02/20(10:00)
2013,02,19,82296,76628,71243,5385,7.6,2013/02/19(10:00)
2013,02,18,82296,75669,70278,5391,7.7,2013/02/18(10:00)
2013,02,17,82296,75216,59718,15498,26,2013/02/17(01:00)
2013,02,16,82296,75072,63952,11120,17.4,2013/02/16(11:00)
2013,02,15,82296,77804,69697,8107,11.6,2013/02/15(10:00)
2013,02,14,82296,77815,71414,6401,9,2013/02/14(10:00)
2013,02,13,82296,77572,70551,7021,10,2013/02/13(10:00)
2013,02,12,82296,76879,62525,14354,23,2013/02/12(12:00)
2013,02,11,82296,76286,56338,19948,35.4,2013/02/11(24:00)
2013,02,10,82296,75694,54678,21016,38.4,2013/02/10(01:00)
2013,02,09,82296,76723,62468,14255,22.8,2013/02/09(01:00)
2013,02,08,82296,79482,74196,5286,7.1,2013/02/08(01:00)
2013,02,07,82296,79338,73964,5374,7.3,2013/02/07(10:00)
2013,02,06,82296,79022,70985,8037,11.3,2013/02/06(10:00)
2013,02,05,82296,78931,72515,6416,8.8,2013/02/05(10:00)
2013,02,04,82296,78475,70352,8123,11.5,2013/02/04(10:00)
2013,02,03,82296,76538,60333,16205,26.9,2013/02/03(24:00)
2013,02,02,82296,75023,62234,12789,20.5,2013/02/02(24:00)
2013,02,01,82296,78642,67350,11292,16.8,2013/02/01(10:00)
2013,01,31,82296,79320,69136,10184,14.7,2013/01/31(10:00)
2013,01,30,82296,79606,70366,9240,13.1,2013/01/30(10:00)
2013,01,29,82296,80537,72309,8228,11.4,2013/01/29(10:00)
2013,01,28,82296,79415,73589,5826,7.9,2013/01/28(10:00)
2013,01,27,82296,77344,63092,14252,22.6,2013/01/27(01:00)
2013,01,26,82296,79541,66011,13530,20.5,2013/01/26(01:00)
2013,01,25,82296,80578,73340,7238,9.9,2013/01/25(10:00)
2013,01,24,82296,80037,70895,9142,12.9,2013/01/24(10:00)
2013,01,23,82296,79568,70555,9013,12.8,2013/01/23(10:00)
2013,01,22,82296,78867,70439,8428,12,2013/01/22(10:00)
2013,01,21,82296,80040,71696,8344,11.6,2013/01/21(15:00)
2013,01,20,82296,78117,61013,17104,28,2013/01/20(01:00)
2013,01,19,82296,79390,64737,14653,22.6,2013/01/19(01:00)
2013,01,18,82296,80077,74135,5942,8,2013/01/18(10:00)
2013,01,17,82296,81332,73613,7719,10.5,2013/01/17(10:00)
2013,01,16,82296,80558,72808,7750,10.6,2013/01/16(10:00)
2013,01,15,82296,80545,73364,7181,9.8,2013/01/15(10:00)
2013,01,14,82296,80296,72869,7427,10.2,2013/01/14(10:00)
2013,01,13,82296,78708,61334,17374,28.3,2013/01/13(01:00)
2013,01,12,82296,78759,65458,13301,20.3,2013/01/12(01:00)
2013,01,11,82296,81220,75583,5637,7.5,2013/01/11(10:00)
2013,01,10,82296,81360,75570,5790,7.7,2013/01/10(10:00)
2013,01,09,82296,81318,75609,5709,7.6,2013/01/09(10:00)
2013,01,08,82296,80944,75220,5724,7.6,2013/01/08(10:00)
2013,01,07,82296,80129,75383,4746,6.3,2013/01/07(10:00)
2013,01,06,82296,80965,64147,16818,26.2,2013/01/06(01:00)
2013,01,05,82296,80620,68053,12567,18.5,2013/01/05(01:00)
2013,01,04,82296,80843,76375,4468,5.9,2013/01/04(11:00)
2013,01,03,82296,80713,76522,4191,5.5,2013/01/03(11:00)
2013,01,02,82296,80125,73387,6738,9.2,2013/01/02(18:00)
2013,01,01,82296,76730,60178,16552,27.5,2013/01/01(01:00)
2012,12,31,81806,78269,65266,13003,19.9,2012/12/31(11:00)
2012,12,30,81806,76403,61819,14584,23.6,2012/12/30(24:00)
2012,12,29,81806,74180,63609,10571,16.6,2012/12/29(12:00)
2012,12,28,81806,78431,73073,5358,7.3,2012/12/28(12:00)
2012,12,27,81806,79560,75105,4455,5.9,2012/12/27(11:00)
2012,12,26,81806,79972,75987,3985,5.2,2012/12/26(11:00)
2012,12,25,81806,78589,65874,12715,19.3,2012/12/25(01:00)
2012,12,24,81806,79445,74300,5145,6.9,2012/12/24(11:00)
2012,12,23,81806,77136,63306,13830,21.8,2012/12/23(24:00)
2012,12,22,81806,75680,64515,11165,17.3,2012/12/22(11:00)
2012,12,21,81806,79337,74947,4390,5.9,2012/12/21(11:00)
2012,12,20,81806,79540,75154,4386,5.8,2012/12/20(11:00)
2012,12,19,81806,77914,67769,10145,15,2012/12/19(19:00)
2012,12,18,81806,79723,75172,4551,6.1,2012/12/18(11:00)
2012,12,17,81806,77109,72407,4702,6.5,2012/12/17(11:00)
2012,12,16,81806,74541,59375,15166,25.5,2012/12/16(24:00)
2012,12,15,81806,74497,63513,10984,17.3,2012/12/15(11:00)
2012,12,14,81806,78112,73928,4184,5.7,2012/12/14(12:00)
2012,12,13,81806,78018,73244,4774,6.5,2012/12/13(11:00)
2012,12,12,81806,77915,73890,4025,5.4,2012/12/12(11:00)
2012,12,11,81806,77785,74052,3733,5,2012/12/11(11:00)
2012,12,10,81806,78748,74269,4479,6,2012/12/10(11:00)
2012,12,09,81806,76236,62638,13598,21.7,2012/12/09(24:00)
2012,12,08,81806,75673,64826,10847,16.7,2012/12/08(12:00)
2012,12,07,81806,77087,73291,3796,5.2,2012/12/07(12:00)
2012,12,06,81806,77176,72744,4432,6.1,2012/12/06(18:00)
2012,12,05,81806,77353,72502,4851,6.7,2012/12/05(11:00)
2012,12,04,81806,76647,71774,4873,6.8,2012/12/04(18:00)
2012,12,03,81806,75410,70771,4639,6.6,2012/12/03(11:00)
2012,12,02,81806,73052,57401,15651,27.3,2012/12/02(24:00)
2012,12,01,81806,71837,60745,11092,18.3,2012/12/01(11:00)
2012,11,30,81738,75686,68779,6907,10,2012/11/30(10:00)
2012,11,29,81738,75940,69062,6878,10,2012/11/29(11:00)
2012,11,28,81738,74423,68297,6126,9,2012/11/28(10:00)
2012,11,27,81738,74737,68958,5779,8.4,2012/11/27(10:00)
2012,11,26,81738,74242,68602,5640,8.2,2012/11/26(18:00)
2012,11,25,81738,72643,56021,16622,29.7,2012/11/25(24:00)
2012,11,24,81738,71305,59203,12102,20.4,2012/11/24(24:00)
2012,11,23,81738,72880,66568,6312,9.5,2012/11/23(10:00)
2012,11,22,81738,72661,66803,5858,8.8,2012/11/22(10:00)
2012,11,21,81738,72514,67861,4653,6.9,2012/11/21(10:00)
2012,11,20,81738,72205,67338,4867,7.2,2012/11/20(11:00)
2012,11,19,81738,72035,66846,5189,7.8,2012/11/19(19:00)
2012,11,18,81738,70125,55874,14251,25.5,2012/11/18(23:00)
2012,11,17,81738,69249,58325,10924,18.7,2012/11/17(24:00)
2012,11,16,81738,72320,65817,6503,9.9,2012/11/16(10:00)
2012,11,15,81738,71947,65600,6347,9.7,2012/11/15(19:00)
2012,11,14,81738,71352,65597,5755,8.8,2012/11/14(10:00)
2012,11,13,81738,70894,65071,5823,8.9,2012/11/13(19:00)
2012,11,12,81738,70630,63856,6774,10.6,2012/11/12(19:00)
2012,11,11,81738,68641,54242,14399,26.5,2012/11/11(23:00)
2012,11,10,81738,68618,55606,13012,23.4,2012/11/10(01:00)
2012,11,09,81738,68895,62933,5962,9.5,2012/11/09(10:00)
2012,11,08,81738,69457,63379,6078,9.6,2012/11/08(19:00)
2012,11,07,81738,69335,62448,6887,11,2012/11/07(10:00)
2012,11,06,81738,68811,63871,4940,7.7,2012/11/06(19:00)
2012,11,05,81738,68966,63267,5699,9,2012/11/05(19:00)
2012,11,04,81738,67051,53038,14013,26.4,2012/11/04(23:00)
2012,11,03,81738,67065,55191,11874,21.5,2012/11/03(11:00)
2012,11,02,81738,70266,61775,8491,13.7,2012/11/02(19:00)
2012,11,01,81738,68793,62758,6035,9.6,2012/11/01(19:00)
2012,10,31,81593,67910,61481,6429,10.5,2012/10/31(19:00)
2012,10,30,81593,66709,61165,5544,9.1,2012/10/30(19:00)
2012,10,29,81593,66707,61144,5563,9.1,2012/10/29(19:00)
2012,10,28,81593,64697,51516,13181,25.6,2012/10/28(23:00)
2012,10,27,81593,66361,55277,11084,20.1,2012/10/27(12:00)
2012,10,26,81593,68640,60371,8269,13.7,2012/10/26(19:00)
2012,10,25,81593,68204,61308,6896,11.2,2012/10/25(19:00)
2012,10,24,81593,69151,60965,8186,13.4,2012/10/24(19:00)
2012,10,23,81593,68349,61622,6727,10.9,2012/10/23(19:00)
2012,10,22,81593,67074,61429,5645,9.2,2012/10/22(19:00)
2012,10,21,81593,66967,51456,15511,30.1,2012/10/21(20:00)
2012,10,20,81593,67401,54174,13227,24.4,2012/10/20(11:00)
2012,10,19,81593,68304,60020,8284,13.8,2012/10/19(19:00)
2012,10,18,81593,66903,61039,5864,9.6,2012/10/18(19:00)
2012,10,17,81593,67174,60257,6917,11.5,2012/10/17(19:00)
2012,10,16,81593,67066,60814,6252,10.3,2012/10/16(19:00)
2012,10,15,81593,66468,60196,6272,10.4,2012/10/15(19:00)
2012,10,14,81593,65570,50815,14755,29,2012/10/14(20:00)
2012,10,13,81593,63758,53632,10126,18.9,2012/10/13(11:00)
2012,10,12,81593,67130,59780,7350,12.3,2012/10/12(19:00)
2012,10,11,81593,67032,61169,5863,9.6,2012/10/11(19:00)
2012,10,10,81593,66316,60099,6217,10.3,2012/10/10(19:00)
2012,10,09,81593,66972,60972,6000,9.8,2012/10/09(19:00)
2012,10,08,81593,66529,60359,6170,10.2,2012/10/08(19:00)
2012,10,07,81552,65990,51457,14533,28.2,2012/10/07(20:00)
2012,10,06,81552,65306,55401,9905,17.9,2012/10/06(12:00)
2012,10,05,81552,67403,60138,7265,12.1,2012/10/05(19:00)
2012,10,04,81552,66919,56549,10370,18.3,2012/10/04(19:00)
2012,10,03,81552,63062,51925,11137,21.4,2012/10/03(20:00)
2012,10,02,81552,62826,48778,14048,28.8,2012/10/02(20:00)
2012,10,01,81552,68348,44079,24269,55.1,2012/10/01(20:00)
2012,09,30,81552,68556,41302,27254,66,2012/09/30(23:00)
2012,09,29,81552,68404,46048,22356,48.5,2012/09/29(01:00)
2012,09,28,81552,72886,58686,14200,24.2,2012/09/28(11:00)
2012,09,27,81552,71552,60988,10564,17.3,2012/09/27(15:00)
2012,09,26,81552,72410,61849,10561,17.1,2012/09/26(15:00)
2012,09,25,81552,71943,61999,9944,16,2012/09/25(15:00)
2012,09,24,81552,71787,61955,9832,15.9,2012/09/24(15:00)
2012,09,23,81552,72877,52648,20229,38.4,2012/09/23(20:00)
2012,09,22,81552,72877,56074,16803,30,2012/09/22(12:00)
2012,09,21,81552,74498,61504,12994,21.1,2012/09/21(15:00)
2012,09,20,81552,74582,61933,12649,20.4,2012/09/20(20:00)
2012,09,19,81552,75065,61552,13513,22,2012/09/19(15:00)
2012,09,18,81552,74227,61632,12595,20.4,2012/09/18(15:00)
2012,09,17,81552,73895,60517,13378,22.1,2012/09/17(11:00)
2012,09,16,81552,74634,52053,22581,43.4,2012/09/16(20:00)
2012,09,15,81552,76303,55814,20489,36.7,2012/09/15(12:00)
2012,09,14,81552,77768,61461,16307,26.5,2012/09/14(11:00)
2012,09,13,81552,77646,63730,13916,21.8,2012/09/13(15:00)
2012,09,12,81552,77114,63598,13516,21.3,2012/09/12(15:00)
2012,09,11,81552,77054,63690,13364,21,2012/09/11(15:00)
2012,09,10,81552,76532,63382,13150,20.7,2012/09/10(15:00)
2012,09,09,81552,76663,52607,24056,45.7,2012/09/09(20:00)
2012,09,08,81552,76753,56953,19800,34.8,2012/09/08(12:00)
2012,09,07,81552,77329,64860,12469,19.2,2012/09/07(15:00)
2012,09,06,81552,77408,64096,13312,20.8,2012/09/06(15:00)
2012,09,05,81552,77917,65566,12351,18.8,2012/09/05(15:00)
2012,09,04,81552,77257,66324,10933,16.5,2012/09/04(15:00)
2012,09,03,81552,77111,67693,9418,13.9,2012/09/03(15:00)
2012,09,02,81552,76153,54602,21551,39.5,2012/09/02(20:00)
2012,09,01,81552,75717,58196,17521,30.1,2012/09/01(15:00)
2012,08,31,81552,78223,64788,13435,20.7,2012/08/31(15:00)
2012,08,30,81552,77862,65840,12022,18.3,2012/08/30(11:00)
2012,08,29,81552,77459,68780,8679,12.6,2012/08/29(15:00)
2012,08,28,81552,74527,65715,8812,13.4,2012/08/28(15:00)
2012,08,27,81552,76474,71046,5428,7.6,2012/08/27(15:00)
2012,08,26,81552,76491,58068,18423,31.7,2012/08/26(21:00)
2012,08,25,81552,75261,60599,14662,24.2,2012/08/25(15:00)
2012,08,24,81552,76974,63708,13266,20.8,2012/08/24(15:00)
2012,08,23,81552,76985,64960,12025,18.5,2012/08/23(15:00)
2012,08,22,81552,77145,66037,11108,16.8,2012/08/22(11:00)
2012,08,21,81552,76855,70992,5863,8.3,2012/08/21(15:00)
2012,08,20,81552,76651,71059,5592,7.9,2012/08/20(15:00)
2012,08,19,81552,76612,59360,17252,29.1,2012/08/19(21:00)
2012,08,18,81552,76976,63768,13208,20.7,2012/08/18(12:00)
2012,08,17,81552,77897,71135,6762,9.5,2012/08/17(15:00)
2012,08,16,81552,77836,69481,8355,12,2012/08/16(15:00)
2012,08,15,81552,77711,62387,15324,24.6,2012/08/15(12:00)
2012,08,14,81552,77574,69018,8556,12.4,2012/08/14(15:00)
2012,08,13,81552,77637,69090,8547,12.4,2012/08/13(15:00)
2012,08,12,81552,77839,57960,19879,34.3,2012/08/12(21:00)
2012,08,11,81552,76149,63524,12625,19.9,2012/08/11(15:00)
2012,08,10,81552,77039,70288,6751,9.6,2012/08/10(12:00)
2012,08,09,81552,77093,72940,4153,5.7,2012/08/09(15:00)
2012,08,08,81552,76698,72497,4201,5.8,2012/08/08(15:00)
2012,08,07,81552,76904,73653,3251,4.4,2012/08/07(15:00)
2012,08,06,81552,77082,74291,2791,3.8,2012/08/06(15:00)
2012,08,05,81552,75498,63236,12262,19.4,2012/08/05(21:00)
2012,08,04,81552,73708,62279,11429,18.4,2012/08/04(21:00)
2012,08,03,81552,74686,66851,7835,11.7,2012/08/03(15:00)
2012,08,02,81552,75004,67314,7690,11.4,2012/08/02(15:00)
2012,08,01,81552,75173,68525,6648,9.7,2012/08/01(15:00)
2012,07,31,80552,75927,70763,5164,7.3,2012/07/31(15:00)
2012,07,30,80552,76478,69856,6622,9.5,2012/07/30(15:00)
2012,07,29,80552,75769,60779,14990,24.7,2012/07/29(21:00)
2012,07,28,80552,74416,64680,9736,15.1,2012/07/28(15:00)
2012,07,27,80552,77563,72704,4859,6.7,2012/07/27(12:00)
2012,07,26,80552,77179,72630,4549,6.3,2012/07/26(15:00)
2012,07,25,80552,76906,72784,4122,5.7,2012/07/25(15:00)
2012,07,24,80552,77324,72913,4411,6,2012/07/24(15:00)
2012,07,23,80552,77246,72595,4651,6.4,2012/07/23(15:00)
2012,07,22,80552,75206,57900,17306,29.9,2012/07/22(21:00)
2012,07,21,80552,73351,62512,10839,17.3,2012/07/21(15:00)
2012,07,20,79552,75402,69021,6381,9.2,2012/07/20(15:00)
2012,07,19,79552,75113,67871,7242,10.7,2012/07/19(15:00)
2012,07,18,79552,74931,68952,5979,8.7,2012/07/18(15:00)
2012,07,17,79552,74690,66197,8493,12.8,2012/07/17(15:00)
2012,07,16,79552,74560,64442,10118,15.7,2012/07/16(15:00)
2012,07,15,79552,75134,53714,21420,39.9,2012/07/15(21:00)
2012,07,14,79552,74192,59922,14270,23.8,2012/07/14(12:00)
2012,07,13,79552,74574,68543,6031,8.8,2012/07/13(15:00)
2012,07,12,79552,74438,67740,6698,9.9,2012/07/12(15:00)
2012,07,11,79552,74840,67862,6978,10.3,2012/07/11(15:00)
2012,07,10,79552,73993,67961,6032,8.9,2012/07/10(15:00)
2012,07,09,79552,73081,68751,4330,6.3,2012/07/09(17:00)
2012,07,08,79552,71963,54057,17906,33.1,2012/07/08(21:00)
2012,07,07,79552,72062,57899,14163,24.5,2012/07/07(12:00)
2012,07,06,79552,72385,65582,6803,10.4,2012/07/06(15:00)
2012,07,05,79552,72318,66378,5940,8.9,2012/07/05(15:00)
2012,07,04,79552,72449,67858,4591,6.8,2012/07/04(15:00)
2012,07,03,79552,71681,66433,5248,7.9,2012/07/03(15:00)
2012,07,02,79552,71481,65642,5839,8.9,2012/07/02(15:00)
2012,07,01,79552,70096,53160,16936,31.9,2012/07/01(21:00)
2012,06,30,79552,68268,59230,9038,15.3,2012/06/30(12:00)
2012,06,29,79552,71823,67390,4433,6.6,2012/06/29(15:00)
2012,06,28,79552,72179,65842,6337,9.6,2012/06/28(15:00)
2012,06,27,79552,72026,65558,6468,9.9,2012/06/27(15:00)
2012,06,26,79552,72099,65382,6717,10.3,2012/06/26(15:00)
2012,06,25,79552,71940,66791,5149,7.7,2012/06/25(15:00)
2012,06,24,79552,69137,54183,14954,27.6,2012/06/24(21:00)
2012,06,23,79552,71000,60035,10965,18.3,2012/06/23(15:00)
2012,06,22,79522,71963,66429,5534,8.3,2012/06/22(15:00)
2012,06,21,79552,72375,66934,5441,8.1,2012/06/21(17:00)
2012,06,20,79432,72235,67009,5226,7.8,2012/06/20(15:00)
2012,06,19,79432,71275,66982,4293,6.4,2012/06/19(15:00)
2012,06,18,79432,70254,66205,4049,6.1,2012/06/18(15:00)
2012,06,17,79432,67228,53298,13930,26.1,2012/06/17(21:00)
2012,06,16,79432,67250,58330,8920,15.3,2012/06/16(12:00)
2012,06,15,79432,69375,63990,5385,8.4,2012/06/15(12:00)
2012,06,14,79432,69561,64546,5015,7.8,2012/06/14(17:00)
2012,06,13,79432,69132,63780,5352,8.4,2012/06/13(15:00)
2012,06,12,79432,68713,64506,4207,6.5,2012/06/12(15:00)
2012,06,11,79432,68520,63222,5298,8.4,2012/06/11(15:00)
2012,06,10,79432,65838,52788,13050,24.7,2012/06/10(21:00)
2012,06,09,79432,64763,57383,7380,12.9,2012/06/09(15:00)
2012,06,08,79432,67317,62556,4761,7.6,2012/06/08(15:00)
2012,06,07,79432,66781,63340,3441,5.4,2012/06/07(15:00)
2012,06,06,79432,66085,59139,6946,11.7,2012/06/06(15:00)
2012,06,05,79432,67117,62958,4159,6.6,2012/06/05(15:00)
2012,06,04,79432,66931,62206,4725,7.6,2012/06/04(15:00)
2012,06,03,79432,64378,51865,12513,24.1,2012/06/03(21:00)
2012,06,02,79432,62226,56122,6104,10.9,2012/06/02(12:00)
2012,06,01,79432,65095,60411,4684,7.8,2012/06/01(15:00)
2012,05,31,79432,65160,60991,4169,6.8,2012/05/31(15:00)
2012,05,30,79432,65883,60395,5488,9.1,2012/05/30(17:00)
2012,05,29,79432,65095,60116,4979,8.3,2012/05/29(17:00)
2012,05,28,79432,64073,53876,10197,18.9,2012/05/28(21:00)
2012,05,27,79432,61403,50165,11238,22.4,2012/05/27(21:00)
2012,05,26,79432,61720,54131,7589,14,2012/05/26(12:00)
2012,05,25,79432,66444,60262,6182,10.3,2012/05/25(15:00)
2012,05,24,79432,65855,60583,5272,8.7,2012/05/24(15:00)
2012,05,23,79432,65529,61029,4500,7.4,2012/05/23(15:00)
2012,05,22,79432,65600,60915,4685,7.7,2012/05/22(15:00)
2012,05,21,79432,64425,59738,4687,7.8,2012/05/21(17:00)
2012,05,20,79432,63140,51396,11744,22.9,2012/05/20(21:00)
2012,05,19,79432,62762,54050,8712,16.1,2012/05/19(12:00)
2012,05,18,79432,64337,58805,5532,9.4,2012/05/18(12:00)
2012,05,17,79432,65656,59354,6302,10.6,2012/05/17(11:00)
2012,05,16,79432,65950,59297,6653,11.2,2012/05/16(15:00)
2012,05,15,79432,65684,59545,6139,10.3,2012/05/15(15:00)
2012,05,14,79432,65847,60105,5742,9.6,2012/05/14(15:00)
2012,05,13,79432,64424,50870,13554,26.6,2012/05/13(21:00)
2012,05,12,79432,63333,53474,9859,18.4,2012/05/12(11:00)
2012,05,11,79432,65776,59389,6387,10.8,2012/05/11(17:00)
2012,05,10,79432,64651,59469,5182,8.7,2012/05/10(17:00)
2012,05,09,79432,64450,59180,5270,8.9,2012/05/09(15:00)
2012,05,08,79432,64388,59726,4662,7.8,2012/05/08(15:00)
2012,05,07,79432,64703,58783,5920,10.1,2012/05/07(15:00)
2012,05,06,79432,63838,49265,14573,29.6,2012/05/06(21:00)
2012,05,05,79732,62753,51023,11730,23,2012/05/05(21:00)
2012,05,04,79432,64206,58254,5952,10.2,2012/05/04(15:00)
2012,05,03,79432,64136,58681,5455,9.3,2012/05/03(15:00)
2012,05,02,79432,63419,59194,4225,7.1,2012/05/02(15:00)
2012,05,01,79432,63986,53469,10517,19.7,2012/05/01(21:00)
2012,04,30,79432,63614,57303,6311,11,2012/04/30(17:00)
2012,04,29,79432,63015,50060,12955,25.9,2012/04/29(21:00)
2012,04,28,79432,65313,52289,13024,24.9,2012/04/28(11:00)
2012,04,27,79432,66367,57420,8947,15.6,2012/04/27(15:00)
2012,04,26,79432,66414,58571,7843,13.4,2012/04/26(20:00)
2012,04,25,79432,65664,60184,5480,9.1,2012/04/25(15:00)
2012,04,24,79432,64662,57954,6708,11.6,2012/04/24(21:00)
2012,04,23,79432,65692,59092,6600,11.2,2012/04/23(11:00)
2012,04,22,79432,62827,51897,10930,21.1,2012/04/22(23:00)
2012,04,21,79432,62424,56020,6404,11.4,2012/04/21(12:00)
2012,04,20,79432,66515,58827,7688,13.1,2012/04/20(20:00)
2012,04,19,79432,66638,59736,6902,11.6,2012/04/19(20:00)
2012,04,18,79432,65974,58531,7443,12.7,2012/04/18(11:00)
2012,04,17,79432,66163,59495,6668,11.2,2012/04/17(20:00)
2012,04,16,79432,65870,59317,6553,11,2012/04/16(20:00)
2012,04,15,79432,63956,51032,12924,25.3,2012/04/15(23:00)
2012,04,14,79432,65061,54323,10738,19.8,2012/04/14(11:00)
2012,04,13,79432,67398,59998,7400,12.3,2012/04/13(20:00)
2012,04,12,79432,67787,60318,7469,12.4,2012/04/12(20:00)
2012,04,11,79432,67406,57192,10214,17.9,2012/04/11(11:00)
2012,04,10,79432,66938,60615,6323,10.4,2012/04/10(17:00)
2012,04,09,79432,67012,59632,7380,12.4,2012/04/09(11:00)
2012,04,08,79432,66356,52545,13811,26.3,2012/04/08(23:00)
2012,04,07,79432,66934,56470,10464,18.5,2012/04/07(11:00)
2012,04,06,79432,69404,61955,7449,12,2012/04/06(11:00)
2012,04,05,79432,69374,61447,7927,12.9,2012/04/05(20:00)
2012,04,04,79432,69319,62455,6864,11,2012/04/04(10:00)
2012,04,03,79432,69474,64390,5084,7.9,2012/04/03(11:00)
2012,04,02,79432,69866,62058,7808,12.6,2012/04/02(11:00)
2012,04,01,79432,68340,53824,14516,27,2012/04/01(23:00)
2012,03,31,79648,68874,55993,12881,23,2012/03/31(24:00)
2012,03,30,79648,69940,62686,7254,11.6,2012/03/30(11:00)
2012,03,29,79648,70777,61505,9272,15.1,2012/03/29(10:00)
2012,03,28,79648,71122,62671,8451,13.5,2012/03/28(10:00)
2012,03,27,79648,71373,64132,7241,11.3,2012/03/27(11:00)
2012,03,26,79648,71863,65406,6457,9.9,2012/03/26(11:00)
2012,03,25,79648,70747,55600,15147,27.2,2012/03/25(23:00)
2012,03,24,79648,70539,58455,12084,20.7,2012/03/24(24:00)
2012,03,23,79648,72152,65916,6236,9.5,2012/03/23(11:00)
2012,03,22,79648,72030,66314,5716,8.6,2012/03/22(11:00)
2012,03,21,79648,73008,65554,7454,11.4,2012/03/21(10:00)
2012,03,20,79648,72901,65917,6984,10.6,2012/03/20(10:00)
2012,03,19,79648,72879,65929,6950,10.5,2012/03/19(11:00)
2012,03,18,79648,69438,55516,13922,25.1,2012/03/18(23:00)
2012,03,17,79648,69509,58487,11022,18.8,2012/03/17(11:00)
2012,03,16,79648,73753,65949,7804,11.8,2012/03/16(11:00)
2012,03,15,79648,73696,66662,7034,10.6,2012/03/15(10:00)
2012,03,14,79648,73918,67941,5977,8.8,2012/03/14(10:00)
2012,03,13,79648,74651,67944,6707,9.9,2012/03/13(10:00)
2012,03,12,79648,75420,69180,6240,9,2012/03/12(11:00)
2012,03,11,79648,72420,58214,14206,24.4,2012/03/11(24:00)
2012,03,10,79648,71155,59193,11962,20.2,2012/03/10(11:00)
2012,03,09,79648,73878,67403,6475,9.6,2012/03/09(11:00)
2012,03,08,79648,74527,67407,7120,10.6,2012/03/08(10:00)
2012,03,07,79648,74302,67480,6822,10.1,2012/03/07(10:00)
2012,03,06,79342,73986,68119,5867,8.6,2012/03/06(11:00)
2012,03,05,79342,74085,67475,6610,9.8,2012/03/05(11:00)
2012,03,04,79342,73226,55923,17303,30.9,2012/03/04(23:00)
2012,03,03,79342,73369,57884,15485,26.8,2012/03/03(24:00)
2012,03,02,79342,74949,65461,9488,14.5,2012/03/02(11:00)
2012,03,01,79342,74921,59676,15245,25.5,2012/03/01(23:00)
2012,02,29,79342,75066,66910,8156,12.2,2012/02/29(10:00)
2012,02,28,79342,76552,69091,7461,10.8,2012/02/28(10:00)
2012,02,27,79342,75408,68116,7292,10.7,2012/02/27(11:00)
2012,02,26,79342,73833,58687,15146,25.8,2012/02/26(24:00)
2012,02,25,79342,76126,60731,15395,25.3,2012/02/25(24:00)
2012,02,24,79342,77736,66140,11596,17.5,2012/02/24(10:00)
2012,02,23,79342,77384,66267,11117,16.8,2012/02/23(10:00)
2012,02,22,79342,77978,68837,9141,13.3,2012/02/22(10:00)
2012,02,21,79342,77532,70066,7466,10.7,2012/02/21(10:00)
2012,02,20,79342,77591,70433,7158,10.2,2012/02/20(10:00)
2012,02,19,79342,77627,60733,16894,27.8,2012/02/19(01:00)
2012,02,18,79342,77710,64121,13589,21.2,2012/02/18(11:00)
2012,02,17,79342,77791,70987,6804,9.6,2012/02/17(10:00)
2012,02,16,79342,78080,69414,8666,12.5,2012/02/16(10:00)
2012,02,15,79342,77973,69690,8283,11.9,2012/02/15(10:00)
2012,02,14,79342,77780,70253,7527,10.7,2012/02/14(10:00)
2012,02,13,79342,77402,71147,6255,8.8,2012/02/13(11:00)
2012,02,12,79342,77513,60365,17148,28.4,2012/02/12(01:00)
2012,02,11,79342,78199,64071,14128,22.1,2012/02/11(01:00)
2012,02,10,79342,78845,72535,6310,8.7,2012/02/10(10:00)
2012,02,09,79342,78802,72432,6370,8.8,2012/02/09(10:00)
2012,02,08,79342,79594,73131,6463,8.8,2012/02/08(10:00)
2012,02,07,79342,79034,73098,5936,8.1,2012/02/07(10:00)
2012,02,06,79342,78517,72008,6509,9,2012/02/06(10:00)
2012,02,05,79342,77110,61327,15783,25.7,2012/02/05(01:00)
2012,02,04,79342,77440,65486,11954,18.3,2012/02/04(01:00)
2012,02,03,79342,79449,73040,6409,8.8,2012/02/03(11:00)
2012,02,02,79342,79505,73833,5672,7.7,2012/02/02(11:00)
2012,02,01,79342,79433,72012,7421,10.3,2012/02/01(15:00)
2012,01,31,79342,79358,72308,7050,9.7,2012/01/31(10:00)
2012,01,30,79342,79502,71609,7893,11,2012/01/30(11:00)
2012,01,29,79342,78744,60436,18308,30.3,2012/01/29(24:00)
2012,01,28,79342,78278,63016,15262,24.2,2012/01/28(11:00)
2012,01,27,79342,79229,71023,8206,11.6,2012/01/27(11:00)
2012,01,26,79342,79444,70451,8993,12.8,2012/01/26(11:00)
2012,01,25,79342,78691,63424,15267,24.1,2012/01/25(12:00)
2012,01,24,79342,77254,56051,21203,37.8,2012/01/24(24:00)
2012,01,23,79342,77051,53318,23733,44.5,2012/01/23(24:00)
2012,01,22,79342,75962,54550,21412,39.3,2012/01/22(24:00)
2012,01,21,79342,77702,58618,19084,32.6,2012/01/21(01:00)
2012,01,20,79342,78701,66299,12402,18.7,2012/01/20(10:00)
2012,01,19,79342,78219,69189,9030,13.1,2012/01/19(10:00)
2012,01,18,79342,78992,69874,9118,13,2012/01/18(10:00)
2012,01,17,79342,78532,69998,8534,12.2,2012/01/17(01:00)
2012,01,16,79342,78635,71422,7213,10.1,2012/01/16(10:00)
2012,01,15,79342,78840,60377,18463,30.6,2012/01/15(24:00)
2012,01,14,79342,77885,63746,14139,22.2,2012/01/14(11:00)
2012,01,13,79342,78157,71893,6264,8.7,2012/01/13(10:00)
2012,01,12,79342,78388,71980,6408,8.9,2012/01/12(11:00)
2012,01,11,79342,79069,72453,6616,9.1,2012/01/11(10:00)
2012,01,10,79342,78816,71620,7196,10,2012/01/10(10:00)
2012,01,09,79342,78728,71646,7082,9.9,2012/01/09(10:00)
2012,01,08,79342,78074,61089,16985,27.8,2012/01/08(01:00)
2012,01,07,79342,77924,64570,13354,20.7,2012/01/07(11:00)
2012,01,06,79342,78897,72552,6345,8.7,2012/01/06(10:00)
2012,01,05,79342,79061,72199,6862,9.5,2012/01/05(10:00)
2012,01,04,79342,78969,72865,6104,8.4,2012/01/04(10:00)
2012,01,03,79342,78653,71631,7022,9.8,2012/01/03(10:00)
2012,01,02,79342,78563,69015,9548,13.8,2012/01/02(11:00)
2012,01,01,79342,78281,58124,20157,34.7,2012/01/01(24:00)
2011,12,31,79342,79891,60312,19579,32.5,2011/12/31(01:00)
2011,12,30,79342,80044,68524,11520,16.8,2011/12/30(10:00)
2011,12,29,79342,80094,68986,11108,16.1,2011/12/29(10:00)
2011,12,28,79342,79813,71482,8331,11.7,2011/12/28(10:00)
2011,12,27,79342,79705,72554,7151,9.9,2011/12/27(10:00)
2011,12,26,79342,79440,72128,7312,10.1,2011/12/26(11:00)
2011,12,25,79342,77224,60765,16459,27.1,2011/12/25(24:00)
2011,12,24,79342,79009,63489,15520,24.4,2011/12/24(01:00)
2011,12,23,79342,79663,71886,7777,10.8,2011/12/23(10:00)
2011,12,22,79342,79063,70990,8073,11.4,2011/12/22(10:00)
2011,12,21,79342,78469,70090,8379,12,2011/12/21(10:00)
2011,12,20,79342,78095,71573,6522,9.1,2011/12/20(10:00)
2011,12,19,79342,77097,71145,5952,8.4,2011/12/19(10:00)
2011,12,18,79342,76394,60134,16260,27,2011/12/18(24:00)
2011,12,17,79342,75751,64187,11564,18,2011/12/17(11:00)
2011,12,16,79342,76723,69899,6824,9.8,2011/12/16(17:00)
2011,12,15,79342,75863,68667,7196,10.5,2011/12/15(17:00)
2011,12,14,79213,75231,68985,6246,9.1,2011/12/14(10:00)
2011,12,13,79213,77518,69017,8501,12.3,2011/12/13(11:00)
2011,12,12,79213,77133,67595,9538,14.1,2011/12/12(18:00)
2011,12,11,79213,76271,57849,18422,31.8,2011/12/11(01:00)
2011,12,10,79213,75643,61464,14179,23.1,2011/12/10(11:00)
2011,12,09,79213,76942,69410,7532,10.9,2011/12/09(11:00)
2011,12,08,79213,76779,68671,8108,11.8,2011/12/08(18:00)
2011,12,07,79213,77449,66500,10949,16.5,2011/12/07(11:00)
2011,12,06,79213,77572,67180,10392,15.5,2011/12/06(11:00)
2011,12,05,79213,77270,67115,10155,15.1,2011/12/05(18:00)
2011,12,04,79213,75204,55878,19326,34.6,2011/12/04(24:00)
2011,12,03,79213,74497,57807,16690,28.9,2011/12/03(11:00)
2011,12,02,79213,76908,65139,11769,18.1,2011/12/02(11:00)
2011,12,01,79213,76409,65542,10867,16.6,2011/12/01(18:00)
2011,11,30,79213,77072,64892,12180,18.8,2011/11/30(15:00)
2011,11,29,79213,75656,63079,12577,19.9,2011/11/29(18:00)
2011,11,28,79213,74543,62210,12333,19.8,2011/11/28(11:00)
2011,11,27,79213,72207,54280,17927,33,2011/11/27(01:00)
2011,11,26,79213,72069,58814,13255,22.5,2011/11/26(11:00)
2011,11,25,79213,75040,66512,8528,12.8,2011/11/25(10:00)
2011,11,24,79213,75460,67554,7906,11.7,2011/11/24(18:00)
2011,11,23,79213,76153,66818,9335,14,2011/11/23(18:00)
2011,11,22,79213,74856,65709,9147,13.9,2011/11/22(18:00)
2011,11,21,79213,75221,65357,9864,15.1,2011/11/21(19:00)
2011,11,20,79213,73469,54654,18815,34.4,2011/11/20(23:00)
2011,11,19,79213,72269,55031,17238,31.3,2011/11/19(11:00)
2011,11,18,79213,75094,61210,13884,22.7,2011/11/18(18:00)
2011,11,17,79213,75098,62286,12812,20.6,2011/11/17(19:00)
2011,11,16,79213,75005,61292,13713,22.4,2011/11/16(19:00)
2011,11,15,79213,75560,62550,13010,20.8,2011/11/15(19:00)
2011,11,14,79213,75331,62271,13060,21,2011/11/14(19:00)
2011,11,13,79213,74064,52104,21960,42.1,2011/11/13(23:00)
2011,11,12,79213,73259,54054,19205,35.5,2011/11/12(11:00)
2011,11,11,79213,74649,60197,14452,24,2011/11/11(19:00)
2011,11,10,79213,73870,61125,12745,20.9,2011/11/10(19:00)
2011,11,09,79213,72781,60409,12372,20.5,2011/11/09(19:00)
2011,11,08,79213,72364,61174,11190,18.3,2011/11/08(19:00)
2011,11,07,79213,72931,60708,12223,20.1,2011/11/07(19:00)
2011,11,06,79213,70613,51533,19080,37,2011/11/06(23:00)
2011,11,05,79213,68640,54200,14440,26.6,2011/11/05(12:00)
2011,11,04,79213,70597,60326,10271,17,2011/11/04(19:00)
2011,11,03,79213,72140,60915,11225,18.4,2011/11/03(19:00)
2011,11,02,79213,72063,60192,11871,19.7,2011/11/02(19:00)
2011,11,01,79213,71945,60289,11656,19.3,2011/11/01(19:00)
2011,10,31,79213,71995,60913,11082,18.2,2011/10/31(19:00)
2011,10,30,78813,67857,51704,16153,31.2,2011/10/30(23:00)
2011,10,29,78813,68125,55053,13072,23.7,2011/10/29(11:00)
2011,10,28,78813,70804,60753,10051,16.5,2011/10/28(19:00)
2011,10,27,78813,70758,61921,8837,14.3,2011/10/27(19:00)
2011,10,26,78813,71077,61599,9478,15.4,2011/10/26(19:00)
2011,10,25,78813,71261,62575,8686,13.9,2011/10/25(19:00)
2011,10,24,78813,71308,61578,9730,15.8,2011/10/24(19:00)
2011,10,23,78813,69284,51428,17856,34.7,2011/10/23(23:00)
2011,10,22,78813,70165,54621,15544,28.5,2011/10/22(11:00)
2011,10,21,78813,71264,60554,10710,17.7,2011/10/21(19:00)
2011,10,20,78813,71075,61343,9732,15.9,2011/10/20(19:00)
2011,10,19,78813,71075,60644,10431,17.2,2011/10/19(19:00)
2011,10,18,78813,71029,61448,9581,15.6,2011/10/18(19:00)
2011,10,17,78813,70421,61107,9314,15.2,2011/10/17(19:00)
2011,10,16,78813,67909,50957,16952,33.3,2011/10/16(23:00)
2011,10,15,78813,69893,53962,15931,29.5,2011/10/15(12:00)
2011,10,14,78813,69937,60044,9893,16.5,2011/10/14(19:00)
2011,10,13,78813,69436,60907,8529,14,2011/10/13(19:00)
2011,10,12,78813,69499,60476,9023,14.9,2011/10/12(19:00)
2011,10,11,78813,69354,60691,8663,14.3,2011/10/11(19:00)
2011,10,10,78813,70164,60712,9452,15.6,2011/10/10(19:00)
2011,10,09,78813,67647,50842,16805,33.1,2011/10/09(20:00)
2011,10,08,78813,67923,53737,14186,26.4,2011/10/08(11:00)
2011,10,07,78813,69673,59674,9999,16.8,2011/10/07(19:00)
2011,10,06,78813,70922,60086,10836,18,2011/10/06(19:00)
2011,10,05,78813,71323,59182,12141,20.5,2011/10/05(19:00)
2011,10,04,78813,70880,59282,11598,19.6,2011/10/04(19:00)
2011,10,03,78813,69938,53024,16914,31.9,2011/10/03(20:00)
2011,10,02,78813,68207,49454,18753,37.9,2011/10/02(23:00)
2011,10,01,78813,69755,52404,17351,33.1,2011/10/01(11:00)
2011,09,30,78813,70389,57516,12873,22.4,2011/09/30(20:00)
2011,09,29,78813,69558,60274,9284,15.4,2011/09/29(19:00)
2011,09,28,78813,69942,59963,9979,16.6,2011/09/28(15:00)
2011,09,27,78813,70085,61003,9082,14.9,2011/09/27(20:00)
2011,09,26,78813,70085,60018,10067,16.8,2011/09/26(20:00)
2011,09,25,78813,68698,51479,17219,33.4,2011/09/25(20:00)
2011,09,24,78813,67993,54366,13627,25.1,2011/09/24(12:00)
2011,09,23,78813,69907,59500,10407,17.5,2011/09/23(15:00)
2011,09,22,78813,70786,59707,11079,18.6,2011/09/22(20:00)
2011,09,21,78813,70175,58737,11438,19.5,2011/09/21(15:00)
2011,09,20,78813,70317,59172,11145,18.8,2011/09/20(20:00)
2011,09,19,78813,70624,59227,11397,19.2,2011/09/19(20:00)
2011,09,18,78813,70022,52738,17284,32.8,2011/09/18(20:00)
2011,09,17,78813,69489,62936,6553,10.4,2011/09/17(15:00)
2011,09,16,78813,70811,67405,3406,5.1,2011/09/16(15:00)
2011,09,15,78813,70622,67281,3341,5,2011/09/15(15:00)
2011,09,14,78813,70135,58754,11381,19.4,2011/09/14(17:00)
2011,09,13,78813,72425,48043,24382,50.8,2011/09/13(20:00)
2011,09,12,78813,71797,42993,28804,67,2011/09/12(21:00)
2011,09,11,78813,72602,45021,27581,61.3,2011/09/11(20:00)
2011,09,10,78813,72300,51803,20497,39.6,2011/09/10(11:00)
2011,09,09,78813,74525,62293,12232,19.6,2011/09/09(11:00)
2011,09,08,78813,75421,64524,10897,16.9,2011/09/08(15:00)
2011,09,07,78813,75309,64990,10319,15.9,2011/09/07(15:00)
2011,09,06,78813,75435,66278,9157,13.8,2011/09/06(15:00)
2011,09,05,78813,75673,66594,9079,13.6,2011/09/05(15:00)
2011,09,04,78813,74517,54861,19656,35.8,2011/09/04(20:00)
2011,09,03,78813,74446,61977,12469,20.1,2011/09/03(15:00)
2011,09,02,79246,76885,71061,5824,8.2,2011/09/02(15:00)
2011,09,01,79246,77135,70529,6606,9.4,2011/09/01(15:00)
2011,08,31,79246,77636,72194,5442,7.5,2011/08/31(15:00)
2011,08,30,79246,77609,71745,5864,8.2,2011/08/30(15:00)
2011,08,29,79246,77409,70767,6642,9.4,2011/08/29(15:00)
2011,08,28,79246,77616,57034,20582,36.1,2011/08/28(21:00)
2011,08,27,79246,77880,60944,16936,27.8,2011/08/27(12:00)
2011,08,26,79246,78299,66214,12085,18.3,2011/08/26(15:00)
2011,08,25,79246,78340,65285,13055,20,2011/08/25(15:00)
2011,08,24,79246,77907,63959,13948,21.8,2011/08/24(15:00)
2011,08,23,79246,77977,63587,14390,22.6,2011/08/23(15:00)
2011,08,22,79246,77820,64261,13559,21.1,2011/08/22(15:00)
2011,08,21,79246,77977,53116,24861,46.8,2011/08/21(21:00)
2011,08,20,79246,78297,57322,20975,36.6,2011/08/20(12:00)
2011,08,19,79246,78497,65828,12669,19.2,2011/08/19(15:00)
2011,08,18,79246,78297,67527,10770,15.9,2011/08/18(15:00)
2011,08,17,79246,78367,67645,10722,15.9,2011/08/17(15:00)
2011,08,16,79246,78497,68649,9848,14.3,2011/08/16(15:00)
2011,08,15,79246,78497,59826,18671,31.2,2011/08/15(21:00)
2011,08,14,78810,78497,55352,23145,41.8,2011/08/14(21:00)
2011,08,13,78810,78580,60927,17653,29,2011/08/13(12:00)
2011,08,12,78810,78580,68112,10468,15.4,2011/08/12(15:00)
2011,08,11,78810,78580,69587,8993,12.9,2011/08/11(15:00)
2011,08,10,78810,78580,67776,10804,15.9,2011/08/10(15:00)
2011,08,09,78810,78340,67523,10817,16,2011/08/09(15:00)
2011,08,08,78810,77768,66784,10984,16.4,2011/08/08(15:00)
2011,08,07,78810,77702,57003,20699,36.3,2011/08/07(21:00)
2011,08,06,78810,77357,61767,15590,25.2,2011/08/06(15:00)
2011,08,05,78810,78305,67951,10354,15.2,2011/08/05(15:00)
2011,08,04,78810,78120,65124,12996,20,2011/08/04(15:00)
2011,08,03,78810,78120,61244,16876,27.6,2011/08/03(15:00)
2011,08,02,78810,78232,59257,18975,32,2011/08/02(15:00)
2011,08,01,78810,77404,57942,19462,33.6,2011/08/01(15:00)
2011,07,31,78810,77452,54326,23126,42.6,2011/07/31(21:00)
2011,07,30,78810,76406,58439,17967,30.7,2011/07/30(12:00)
2011,07,29,78810,77715,68254,9461,13.9,2011/07/29(15:00)
2011,07,28,78810,78483,67942,10541,15.5,2011/07/28(15:00)
2011,07,27,78810,78580,67464,11116,16.5,2011/07/27(15:00)
2011,07,26,78810,78580,68964,9616,13.9,2011/07/26(15:00)
2011,07,25,78810,78540,67965,10575,15.6,2011/07/25(15:00)
2011,07,24,78810,78108,55435,22673,40.9,2011/07/24(21:00)
2011,07,23,78810,78318,61339,16979,27.7,2011/07/23(15:00)
2011,07,22,78810,78922,66105,12817,19.4,2011/07/22(15:00)
2011,07,21,78810,78922,69173,9749,14.1,2011/07/21(15:00)
2011,07,20,78810,78722,70350,8372,11.9,2011/07/20(15:00)
2011,07,19,78810,78838,71393,7445,10.4,2011/07/19(15:00)
2011,07,18,78810,78838,70956,7882,11.1,2011/07/18(15:00)
2011,07,17,78810,76350,56518,19832,35.1,2011/07/17(21:00)
2011,07,16,78810,76984,61028,15956,26.1,2011/07/16(12:00)
2011,07,15,78810,76353,67140,9213,13.7,2011/07/15(15:00)
2011,07,14,78810,76839,66480,10359,15.6,2011/07/14(15:00)
2011,07,13,78810,76806,66087,10719,16.2,2011/07/13(15:00)
2011,07,12,78810,76134,65237,10897,16.7,2011/07/12(15:00)
2011,07,11,78810,76889,64240,12649,19.7,2011/07/11(15:00)
2011,07,10,78810,73915,53593,20322,37.9,2011/07/10(21:00)
2011,07,09,78810,75275,58040,17235,29.7,2011/07/09(12:00)
2011,07,08,78810,76081,64283,11798,18.4,2011/07/08(15:00)
2011,07,07,78810,76071,64622,11449,17.7,2011/07/07(15:00)
2011,07,06,78810,76671,65060,11611,17.8,2011/07/06(15:00)
2011,07,05,78810,76671,66128,10543,15.9,2011/07/05(15:00)
2011,07,04,78810,76423,64946,11477,17.7,2011/07/04(15:00)
2011,07,03,78810,75657,53332,22325,41.9,2011/07/03(21:00)
2011,07,02,78810,75716,59613,16103,27,2011/07/02(15:00)
2011,07,01,78810,74834,66358,8476,12.8,2011/07/01(15:00)
2011,06,30,78810,74689,65497,9192,14,2011/06/30(15:00)
2011,06,29,78810,73677,64414,9263,14.4,2011/06/29(15:00)
2011,06,28,78810,72656,64249,8407,13.1,2011/06/28(15:00)
2011,06,27,78810,72760,60942,11818,19.4,2011/06/27(17:00)
2011,06,26,78810,69847,50607,19240,38,2011/06/26(21:00)
2011,06,25,78810,68077,56412,11665,20.7,2011/06/25(12:00)
2011,06,24,78810,71770,63144,8626,13.7,2011/06/24(15:00)
2011,06,23,78810,72782,65856,6926,10.5,2011/06/23(15:00)
2011,06,22,78810,72673,64846,7827,12.1,2011/06/22(15:00)
2011,06,21,78810,71625,66254,5371,8.1,2011/06/21(15:00)
2011,06,20,78810,72091,66872,5219,7.8,2011/06/20(15:00)
2011,06,19,78810,70342,52965,17377,32.8,2011/06/19(21:00)
2011,06,18,78810,70863,57953,12910,22.3,2011/06/18(12:00)
2011,06,17,78810,71950,63935,8015,12.5,2011/06/17(15:00)
2011,06,16,78235,72225,64211,8014,12.5,2011/06/16(15:00)
2011,06,15,78235,72132,63471,8661,13.6,2011/06/15(15:00)
2011,06,14,78235,71870,62196,9674,15.6,2011/06/14(15:00)
2011,06,13,78235,71219,61587,9632,15.6,2011/06/13(15:00)
2011,06,12,78235,70549,51047,19502,38.2,2011/06/12(21:00)
2011,06,11,78235,68200,56286,11914,21.2,2011/06/11(15:00)
2011,06,10,78235,68962,61087,7875,12.9,2011/06/10(15:00)
2011,06,09,78235,67859,60058,7801,13,2011/06/09(16:00)
2011,06,08,78235,69302,61512,7790,12.7,2011/06/08(15:00)
2011,06,07,78235,68021,60236,7785,12.9,2011/06/07(15:00)
2011,06,06,78235,68242,53077,15165,28.6,2011/06/06(21:00)
2011,06,05,78235,67407,49207,18200,37,2011/06/05(21:00)
2011,06,04,78235,67685,53800,13885,25.8,2011/06/04(12:00)
2011,06,03,78235,68377,58488,9889,16.9,2011/06/03(15:00)
2011,06,02,78235,68374,58797,9577,16.3,2011/06/02(17:00)
2011,06,01,78235,68377,57787,10590,18.3,2011/06/01(15:00)
2011,05,31,78235,68944,58616,10328,17.6,2011/05/31(17:00)
2011,05,30,78235,69839,59330,10509,17.7,2011/05/30(15:00)
2011,05,29,78235,69468,50249,19219,38.2,2011/05/29(21:00)
2011,05,28,78235,70985,53420,17565,32.9,2011/05/28(12:00)
2011,05,27,78235,68208,58006,10202,17.6,2011/05/27(17:00)
2011,05,26,78235,68446,58444,10002,17.1,2011/05/26(15:00)
2011,05,25,78235,68265,58637,9628,16.4,2011/05/25(15:00)
2011,05,24,78235,67793,58142,9651,16.6,2011/05/24(15:00)
2011,05,23,78235,68011,57395,10616,18.5,2011/05/23(15:00)
2011,05,22,78235,67407,49822,17585,35.3,2011/05/22(21:00)
2011,05,21,78235,67581,54227,13354,24.6,2011/05/21(12:00)
2011,05,20,78235,68361,59355,9006,15.2,2011/05/20(15:00)
2011,05,19,78235,68105,58085,10020,17.3,2011/05/19(17:00)
2011,05,18,78235,69354,57557,11797,20.5,2011/05/18(15:00)
2011,05,17,78235,70020,56867,13153,23.1,2011/05/17(17:00)
2011,05,16,78235,70143,56752,13391,23.6,2011/05/16(17:00)
2011,05,15,78235,69873,49085,20788,42.4,2011/05/15(21:00)
2011,05,14,78235,69266,52212,17054,32.7,2011/05/14(11:00)
2011,05,13,78235,68985,56468,12517,22.2,2011/05/13(11:00)
2011,05,12,78235,69013,57456,11557,20.1,2011/05/12(15:00)
2011,05,11,78235,69157,58162,10995,18.9,2011/05/11(11:00)
2011,05,10,78235,69457,54245,15212,28,2011/05/10(21:00)
2011,05,09,78235,68605,57426,11179,19.5,2011/05/09(17:00)
2011,05,08,78235,67561,48844,18717,38.3,2011/05/08(23:00)
2011,05,07,78235,66544,53135,13409,25.2,2011/05/07(11:00)
2011,05,06,78235,66530,56584,9946,17.6,2011/05/06(20:00)
2011,05,05,78235,66350,53773,12577,23.4,2011/05/05(23:00)
2011,05,04,78235,66963,57261,9702,16.9,2011/05/04(11:00)
2011,05,03,78235,66710,57474,9236,16.1,2011/05/03(21:00)
2011,05,02,78235,66006,56616,9390,16.6,2011/05/02(20:00)
2011,05,01,78235,66695,49708,16987,34.2,2011/05/01(23:00)
2011,04,30,78235,65897,53761,12136,22.6,2011/04/30(11:00)
2011,04,29,78235,65899,57543,8356,14.5,2011/04/29(11:00)
2011,04,28,78235,65890,58727,7163,12.2,2011/04/28(11:00)
2011,04,27,78235,66431,58652,7779,13.3,2011/04/27(11:00)
2011,04,26,78235,66406,60417,5989,9.9,2011/04/26(11:00)
2011,04,25,78235,66395,58468,7927,13.6,2011/04/25(20:00)
2011,04,24,78235,64752,51836,12916,24.9,2011/04/24(23:00)
2011,04,23,78235,64282,54022,10260,19,2011/04/23(23:00)
2011,04,22,78235,67001,60413,6588,10.9,2011/04/22(11:00)
2011,04,21,78235,67028,58567,8461,14.4,2011/04/21(20:00)
2011,04,20,78235,67043,57945,9098,15.7,2011/04/20(11:00)
2011,04,19,78235,67578,59288,8290,14,2011/04/19(20:00)
2011,04,18,78235,67501,60491,7010,11.6,2011/04/18(11:00)
2011,04,17,78235,67772,51060,16712,32.7,2011/04/17(23:00)
2011,04,16,78235,67878,53422,14456,27.1,2011/04/16(11:00)
2011,04,15,78235,67364,58213,9151,15.7,2011/04/15(20:00)
2011,04,14,78235,68393,58387,10006,17.1,2011/04/14(11:00)
2011,04,13,78235,68429,58167,10262,17.6,2011/04/13(11:00)
2011,04,12,78235,69198,58278,10920,18.7,2011/04/12(20:00)
2011,04,11,78235,69198,59317,9881,16.7,2011/04/11(20:00)
2011,04,10,78235,68164,51540,16624,32.3,2011/04/10(23:00)
2011,04,09,78235,67462,54158,13304,24.6,2011/04/09(23:00)
2011,04,08,78235,70394,58990,11404,19.3,2011/04/08(11:00)
2011,04,07,78235,70371,61400,8971,14.6,2011/04/07(11:00)
2011,04,06,78235,70353,59749,10604,17.7,2011/04/06(11:00)
2011,04,05,78235,70846,59513,11333,19,2011/04/05(20:00)
2011,04,04,78235,70202,60148,10054,16.7,2011/04/04(20:00)
2011,04,03,78235,69094,52487,16607,31.6,2011/04/03(23:00)
2011,04,02,78235,69181,55482,13699,24.7,2011/04/02(11:00)
2011,04,01,78235,69733,59252,10481,17.7,2011/04/01(11:00)
2011,03,31,78235,69709,60600,9109,15,2011/03/31(10:00)
2011,03,30,78235,70092,61571,8521,13.8,2011/03/30(10:00)
2011,03,29,78235,69637,63256,6381,10.1,2011/03/29(11:00)
2011,03,28,78235,70021,62884,7137,11.3,2011/03/28(11:00)
2011,03,27,78235,68950,53874,15076,28,2011/03/27(23:00)
2011,03,26,78235,68950,57412,11538,20.1,2011/03/26(11:00)
2011,03,25,78235,70293,64447,5846,9.1,2011/03/25(11:00)
2011,03,24,78235,69663,63658,6005,9.4,2011/03/24(20:00)
2011,03,23,78235,70522,64073,6449,10.1,2011/03/23(11:00)
2011,03,22,78235,69867,63654,6213,9.8,2011/03/22(20:00)
2011,03,21,78235,70000,61855,8145,13.2,2011/03/21(11:00)
2011,03,20,78235,70359,53881,16478,30.6,2011/03/20(23:00)
2011,03,19,78235,69988,57109,12879,22.6,2011/03/19(11:00)
2011,03,18,78235,70766,64124,6642,10.4,2011/03/18(10:00)
2011,03,17,78235,70766,65740,5026,7.6,2011/03/17(11:00)
2011,03,16,78235,70669,65532,5137,7.8,2011/03/16(11:00)
2011,03,15,78235,70834,64101,6733,10.5,2011/03/15(20:00)
2011,03,14,78235,70626,62730,7896,12.6,2011/03/14(11:00)
2011,03,13,78235,70301,53341,16960,31.8,2011/03/13(23:00)
2011,03,12,78235,69160,57908,11252,19.4,2011/03/12(11:00)
2011,03,11,78235,71794,64038,7756,12.1,2011/03/11(10:00)
2011,03,10,78235,71269,66221,5048,7.6,2011/03/10(11:00)
2011,03,09,78235,71619,65762,5857,8.9,2011/03/09(11:00)
2011,03,08,78235,71499,65497,6002,9.2,2011/03/08(11:00)
2011,03,07,78235,71237,65700,5537,8.4,2011/03/07(11:00)
2011,03,06,78235,70323,55736,14587,26.2,2011/03/06(01:00)
2011,03,05,78235,70323,61100,9223,15.1,2011/03/05(11:00)
2011,03,04,78235,72432,67320,5112,7.6,2011/03/04(11:00)
2011,03,03,78235,72173,67310,4863,7.2,2011/03/03(11:00)
2011,03,02,77235,71183,66746,4437,6.6,2011/03/02(11:00)
2011,03,01,77235,71681,60454,11227,18.6,2011/03/01(24:00)
2011,02,28,77235,71826,65290,6536,10,2011/02/28(11:00)
2011,02,27,77235,72609,55444,17165,31,2011/02/27(24:00)
2011,02,26,77235,72225,58402,13823,23.7,2011/02/26(11:00)
2011,02,25,77235,75939,64032,11907,18.6,2011/02/25(11:00)
2011,02,24,76649,74041,63250,10791,17.1,2011/02/24(10:00)
2011,02,23,76649,73969,64759,9210,14.2,2011/02/23(10:00)
2011,02,22,76649,73583,64954,8629,13.3,2011/02/22(10:00)
2011,02,21,76649,73121,65622,7499,11.4,2011/02/21(11:00)
2011,02,20,76649,73843,57482,16361,28.5,2011/02/20(01:00)
2011,02,19,76649,73843,61327,12516,20.4,2011/02/19(11:00)
2011,02,18,76649,74624,67796,6828,10.1,2011/02/18(11:00)
2011,02,17,76649,75664,68750,6914,10.1,2011/02/17(11:00)
2011,02,16,76649,75367,69763,5604,8,2011/02/16(11:00)
2011,02,15,76649,76252,69913,6339,9.1,2011/02/15(11:00)
2011,02,14,76649,75729,71002,4727,6.7,2011/02/14(11:00)
2011,02,13,76649,75607,60087,15520,25.8,2011/02/13(01:00)
2011,02,12,76649,74682,63786,10896,17.1,2011/02/12(11:00)
2011,02,11,76649,77220,69597,7623,11,2011/02/11(11:00)
2011,02,10,76649,77439,70087,7352,10.5,2011/02/10(11:00)
2011,02,09,76649,76919,67876,9043,13.3,2011/02/09(11:00)
2011,02,08,76649,76452,68791,7661,11.1,2011/02/08(11:00)
2011,02,07,76649,76839,68498,8341,12.2,2011/02/07(11:00)
2011,02,06,76649,76780,57142,19638,34.4,2011/02/06(24:00)
2011,02,05,76649,76602,55570,21032,37.8,2011/02/05(24:00)
2011,02,04,76649,77676,52817,24859,47.1,2011/02/04(24:00)
2011,02,03,76649,79021,50796,28225,55.6,2011/02/03(24:00)
2011,02,02,76649,78597,58340,20257,34.7,2011/02/02(01:00)
2011,02,01,76649,78294,67396,10898,16.2,2011/02/01(11:00)
2011,01,31,76649,76972,71555,5417,7.6,2011/01/31(12:00)
2011,01,30,76649,76673,64028,12645,19.7,2011/01/30(24:00)
2011,01,29,76649,76763,66813,9950,14.9,2011/01/29(12:00)
2011,01,28,76649,77422,72274,5148,7.1,2011/01/28(11:00)
2011,01,27,76131,77422,73014,4408,6,2011/01/27(12:00)
2011,01,26,76131,77422,72292,5130,7.1,2011/01/26(11:00)
2011,01,25,76131,77090,72344,4746,6.6,2011/01/25(11:00)
2011,01,24,76131,77512,71913,5599,7.8,2011/01/24(12:00)
2011,01,23,76131,76968,62263,14705,23.6,2011/01/23(01:00)
2011,01,22,76131,76688,65505,11183,17.1,2011/01/22(12:00)
2011,01,21,76131,76298,71910,4388,6.1,2011/01/21(11:00)
2011,01,20,76131,76831,71918,4913,6.8,2011/01/20(12:00)
2011,01,19,76131,76865,72223,4642,6.4,2011/01/19(12:00)
2011,01,18,76131,76844,72433,4411,6.1,2011/01/18(11:00)
2011,01,17,76131,77179,73137,4042,5.5,2011/01/17(12:00)
2011,01,16,76131,75475,64446,11029,17.1,2011/01/16(01:00)
2011,01,15,76131,75475,66923,8552,12.8,2011/01/15(24:00)
2011,01,14,76131,76125,71569,4556,6.4,2011/01/14(11:00)
2011,01,13,76131,76201,71783,4418,6.2,2011/01/13(11:00)
2011,01,12,76131,76000,71785,4215,5.9,2011/01/12(12:00)
2011,01,11,76131,76000,71687,4313,6,2011/01/11(12:00)
2011,01,10,76131,75910,71840,4070,5.7,2011/01/10(12:00)
2011,01,09,76131,75239,61861,13378,21.6,2011/01/09(24:00)
2011,01,08,76131,74730,65100,9630,14.8,2011/01/08(11:00)
2011,01,07,76131,75931,71423,4508,6.3,2011/01/07(11:00)
2011,01,06,76131,76054,71285,4769,6.7,2011/01/06(19:00)
2011,01,05,76131,75160,70073,5087,7.3,2011/01/05(11:00)
2011,01,04,76131,75045,70869,4176,5.9,2011/01/04(11:00)
2011,01,03,76131,75170,70868,4302,6.1,2011/01/03(12:00)
2011,01,02,76078,75102,59173,15929,26.9,2011/01/02(24:00)
2011,01,01,76078,75003,59796,15207,25.4,2011/01/01(01:00)
2010,12,31,76078,75332,67331,8001,11.9,2010/12/31(11:00)
2010,12,30,76078,75631,69000,6631,9.6,2010/12/30(12:00)
2010,12,29,76078,75213,69708,5505,7.9,2010/12/29(11:00)
2010,12,28,76078,75184,70018,5166,7.4,2010/12/28(12:00)
2010,12,27,76078,75184,70107,5077,7.2,2010/12/27(12:00)
2010,12,26,76078,72246,60856,11390,18.7,2010/12/26(24:00)
2010,12,25,76078,73416,63874,9542,14.9,2010/12/25(01:00)
2010,12,24,76078,74312,69950,4362,6.2,2010/12/24(12:00)
2010,12,23,76078,73962,67320,6642,9.9,2010/12/23(19:00)
2010,12,22,76078,73441,66055,7386,11.2,2010/12/22(10:00)
2010,12,21,76078,74687,67445,7242,10.7,2010/12/21(11:00)
2010,12,20,76078,74551,66377,8174,12.3,2010/12/20(18:00)
2010,12,19,76078,71476,57830,13646,23.6,2010/12/19(01:00)
2010,12,18,76078,72660,62928,9732,15.5,2010/12/18(11:00)
2010,12,17,76078,75763,71060,4703,6.6,2010/12/17(11:00)
2010,12,16,76078,75752,71258,4494,6.3,2010/12/16(11:00)
2010,12,15,76078,75747,71308,4439,6.2,2010/12/15(18:00)
2010,12,14,76078,74371,69614,4757,6.8,2010/12/14(18:00)
2010,12,13,76078,73326,68739,4587,6.7,2010/12/13(11:00)
2010,12,12,76078,73283,57531,15752,27.4,2010/12/12(24:00)
2010,12,11,76078,73558,60423,13135,21.7,2010/12/11(24:00)
2010,12,10,76078,73975,67505,6470,9.6,2010/12/10(11:00)
2010,12,09,76078,73942,67817,6125,9,2010/12/09(18:00)
2010,12,08,76078,73573,67295,6278,9.3,2010/12/08(18:00)
2010,12,07,76078,72721,66728,5993,9,2010/12/07(18:00)
2010,12,06,76078,72430,65324,7106,10.9,2010/12/06(18:00)
2010,12,05,76078,72040,54345,17695,32.6,2010/12/05(01:00)
2010,12,04,76078,71960,59111,12849,21.7,2010/12/04(11:00)
2010,12,03,76078,72131,65414,6717,10.3,2010/12/03(18:00)
2010,12,02,76078,72137,62690,9447,15.1,2010/12/02(18:00)
2010,12,01,76078,71441,62842,8599,13.7,2010/12/01(11:00)
2010,11,30,75950,71431,63154,8277,13.1,2010/11/30(11:00)
2010,11,29,75950,71710,64984,6726,10.4,2010/11/29(11:00)
2010,11,28,75950,71622,55891,15731,28.1,2010/11/28(24:00)
2010,11,27,75950,70695,58710,11985,20.4,2010/11/27(11:00)
2010,11,26,75950,71410,64100,7310,11.4,2010/11/26(18:00)
2010,11,25,75950,71401,63802,7599,11.9,2010/11/25(19:00)
2010,11,24,75950,71467,61352,10115,16.5,2010/11/24(19:00)
2010,11,23,75950,71315,62576,8739,14,2010/11/23(19:00)
2010,11,22,75950,71197,62052,9145,14.7,2010/11/22(19:00)
2010,11,21,75950,70916,52209,18707,35.8,2010/11/21(23:00)
2010,11,20,75950,70072,56191,13881,24.7,2010/11/20(01:00)
2010,11,19,75950,70957,62270,8687,14,2010/11/19(11:00)
2010,11,18,75950,71034,62482,8552,13.7,2010/11/18(19:00)
2010,11,17,75950,71258,61785,9473,15.3,2010/11/17(10:00)
2010,11,16,75950,70958,63204,7754,12.3,2010/11/16(19:00)
2010,11,15,75950,70598,63009,7589,12,2010/11/15(19:00)
2010,11,14,75816,69385,52299,17086,32.7,2010/11/14(23:00)
2010,11,13,75816,69656,54292,15364,28.3,2010/11/13(11:00)
2010,11,12,75816,70319,60282,10037,16.7,2010/11/12(19:00)
2010,11,11,75816,70561,60749,9812,16.2,2010/11/11(19:00)
2010,11,10,75816,70421,60837,9584,15.8,2010/11/10(19:00)
2010,11,09,75816,69379,62623,6756,10.8,2010/11/09(19:00)
2010,11,08,75816,68504,61506,6998,11.4,2010/11/08(19:00)
2010,11,07,75816,68485,50906,17579,34.5,2010/11/07(23:00)
2010,11,06,75816,67841,53375,14466,27.1,2010/11/06(11:00)
2010,11,05,75816,67867,58874,8993,15.3,2010/11/05(19:00)
2010,11,04,75816,67048,60006,7042,11.7,2010/11/04(19:00)
2010,11,03,75816,66780,59648,7132,12,2010/11/03(19:00)
2010,11,02,75816,66577,60444,6133,10.1,2010/11/02(19:00)
2010,11,01,75816,66881,58325,8556,14.7,2010/11/01(19:00)
2010,10,31,75816,67248,50057,17191,34.3,2010/10/31(23:00)
2010,10,30,75816,65889,51919,13970,26.9,2010/10/30(23:00)
2010,10,29,75816,67129,58414,8715,14.9,2010/10/29(19:00)
2010,10,28,75712,66474,60003,6471,10.8,2010/10/28(19:00)
2010,10,27,75712,67067,59328,7739,13,2010/10/27(19:00)
2010,10,26,75712,67227,60330,6897,11.4,2010/10/26(19:00)
2010,10,25,75712,66551,58170,8381,14.4,2010/10/25(19:00)
2010,10,24,75712,65553,49157,16396,33.4,2010/10/24(23:00)
2010,10,23,75712,66025,50843,15182,29.9,2010/10/23(19:00)
2010,10,22,75712,65365,57184,8181,14.3,2010/10/22(19:00)
2010,10,21,75712,65312,58268,7044,12.1,2010/10/21(19:00)
2010,10,20,75712,65503,57494,8009,13.9,2010/10/20(19:00)
2010,10,19,75712,64649,58124,6525,11.2,2010/10/19(19:00)
2010,10,18,75712,64413,57601,6812,11.8,2010/10/18(19:00)
2010,10,17,75712,64677,48850,15827,32.4,2010/10/17(23:00)
2010,10,16,75712,63972,51213,12759,24.9,2010/10/16(19:00)
2010,10,15,75712,65087,57057,8030,14.1,2010/10/15(19:00)
2010,10,14,75712,66480,57818,8662,15,2010/10/14(19:00)
2010,10,13,75712,66453,57364,9089,15.8,2010/10/13(19:00)
2010,10,12,75712,66696,57712,8984,15.6,2010/10/12(19:00)
2010,10,11,75712,66687,57773,8914,15.4,2010/10/11(19:00)
2010,10,10,75712,67086,48332,18754,38.8,2010/10/10(20:00)
2010,10,09,75712,65585,50452,15133,30,2010/10/09(11:00)
2010,10,08,75712,66764,57084,9680,17,2010/10/08(19:00)
2010,10,07,75712,66599,57373,9226,16.1,2010/10/07(19:00)
2010,10,06,74407,67306,56475,10831,19.2,2010/10/06(20:00)
2010,10,05,74407,67170,56438,10732,19,2010/10/05(20:00)
2010,10,04,74407,66662,56515,10147,18,2010/10/04(19:00)
2010,10,03,74407,67125,48264,18861,39.1,2010/10/03(20:00)
2010,10,02,74407,67979,51865,16114,31.1,2010/10/02(12:00)
2010,10,01,74407,67372,55938,11434,20.4,2010/10/01(20:00)
2010,09,30,74407,67634,56247,11387,20.2,2010/09/30(20:00)
2010,09,29,74407,66313,55918,10395,18.6,2010/09/29(20:00)
2010,09,28,74407,66546,56040,10506,18.7,2010/09/28(20:00)
2010,09,27,74407,66591,56095,10496,18.7,2010/09/27(20:00)
2010,09,26,74407,67117,48466,18651,38.5,2010/09/26(20:00)
2010,09,25,74407,66293,48664,17629,36.2,2010/09/25(20:00)
2010,09,24,74407,66645,47132,19513,41.4,2010/09/24(20:00)
2010,09,23,74407,67264,41282,25982,62.9,2010/09/23(20:00)
2010,09,22,74407,67530,38764,28766,74.2,2010/09/22(23:00)
2010,09,21,74407,66730,45151,21579,47.8,2010/09/21(20:00)
2010,09,20,74407,67386,55804,11582,20.8,2010/09/20(12:00)
2010,09,19,74407,67132,52757,14375,27.2,2010/09/19(20:00)
2010,09,18,74407,67123,58479,8644,14.8,2010/09/18(15:00)
2010,09,17,74407,69600,63411,6189,9.8,2010/09/17(15:00)
2010,09,16,74407,69590,62644,6946,11.1,2010/09/16(15:00)
2010,09,15,74407,69590,62527,7063,11.3,2010/09/15(15:00)
2010,09,14,74407,70055,63188,6867,10.9,2010/09/14(15:00)
2010,09,13,74407,70055,62758,7297,11.6,2010/09/13(15:00)
2010,09,12,74407,69801,52039,17762,34.1,2010/09/12(20:00)
2010,09,11,74407,69792,58590,11202,19.1,2010/09/11(15:00)
2010,09,10,74407,70785,64312,6473,10.1,2010/09/10(15:00)
2010,09,09,74407,70785,60665,10120,16.7,2010/09/09(20:00)
2010,09,08,74407,70785,59598,11187,18.8,2010/09/08(12:00)
2010,09,07,74407,70502,63906,6596,10.3,2010/09/07(15:00)
2010,09,06,74407,70785,66362,4423,6.7,2010/09/06(15:00)
2010,09,05,74407,70040,54902,15138,27.6,2010/09/05(20:00)
2010,09,04,74407,70277,62239,8038,12.9,2010/09/04(15:00)
2010,09,03,74407,71936,67802,4134,6.1,2010/09/03(15:00)
2010,09,02,74407,72408,63901,8507,13.3,2010/09/02(17:00)
2010,09,01,74407,73054,68842,4212,6.1,2010/09/01(15:00)
2010,08,31,74407,73053,66242,6811,10.3,2010/08/31(15:00)
2010,08,30,74407,72728,67230,5498,8.2,2010/08/30(15:00)
2010,08,29,74407,73063,54204,18859,34.8,2010/08/29(20:00)
2010,08,28,74407,72038,59400,12638,21.3,2010/08/28(12:00)
2010,08,27,74407,73959,67781,6178,9.1,2010/08/27(15:00)
2010,08,27,74407,73959,67781,6178,9.1,2010/08/27(15:00)
2010,08,26,74407,74579,66283,8296,12.5,2010/08/26(15:00)
2010,08,25,74407,74826,65140,9686,14.9,2010/08/25(12:00)
2010,08,24,74407,73966,66982,6984,10.4,2010/08/24(15:00)
2010,08,23,74407,73966,69404,4562,6.6,2010/08/23(15:00)
2010,08,22,74407,73110,58594,14516,24.8,2010/08/22(21:00)
2010,08,21,74407,73374,64327,9047,14.1,2010/08/21(15:00)
2010,08,20,74407,74344,69886,4458,6.4,2010/08/20(15:00)
2010,08,19,74407,73574,68493,5081,7.4,2010/08/19(15:00)
2010,08,18,74407,73574,67452,6122,9.1,2010/08/18(15:00)
2010,08,17,74407,73259,64676,8583,13.3,2010/08/17(15:00)
2010,08,16,74407,72421,63646,8775,13.8,2010/08/16(12:00)
2010,08,15,74407,72834,54015,18819,34.8,2010/08/15(21:00)
2010,08,14,74407,72521,58726,13795,23.5,2010/08/14(12:00)
2010,08,13,74407,73211,65504,7707,11.8,2010/08/13(15:00)
2010,08,12,74407,73569,63461,10108,15.9,2010/08/12(12:00)
2010,08,11,74407,72696,65206,7490,11.5,2010/08/11(17:00)
2010,08,10,74407,73569,65800,7769,11.8,2010/08/10(15:00)
2010,08,09,74407,73569,67287,6282,9.3,2010/08/09(15:00)
2010,08,08,74407,73103,54975,18128,33,2010/08/08(21:00)
2010,08,07,74407,73193,59045,14148,24,2010/08/07(12:00)
2010,08,06,74407,73820,65633,8187,12.5,2010/08/06(15:00)
2010,08,05,74407,73820,66609,7211,10.8,2010/08/05(15:00)
2010,08,04,74407,73820,62663,11157,17.8,2010/08/04(15:00)
2010,08,03,74407,73820,58086,15734,27.1,2010/08/03(15:00)
2010,08,02,74407,73559,58915,14644,24.9,2010/08/02(15:00)
2010,08,01,74407,72884,53946,18938,35.1,2010/08/01(21:00)
2010,07,31,74407,72301,54739,17562,32.1,2010/07/31(15:00)
2010,07,30,74407,73155,64812,8343,12.9,2010/07/30(15:00)
2010,07,29,74407,73270,66192,7078,10.7,2010/07/29(15:00)
2010,07,28,74407,73270,64904,8366,12.9,2010/07/28(15:00)
2010,07,27,74407,73270,67323,5947,8.8,2010/07/27(15:00)
2010,07,26,74407,73270,65445,7825,12,2010/07/26(15:00)
2010,07,25,74407,73815,53154,20661,38.9,2010/07/25(21:00)
2010,07,24,74407,72905,58717,14188,24.2,2010/07/24(15:00)
2010,07,23,74407,72742,63799,8943,14,2010/07/23(15:00)
2010,07,22,74407,73325,67619,5706,8.4,2010/07/22(15:00)
2010,07,21,74407,73815,66850,6965,10.4,2010/07/21(15:00)
2010,07,20,74407,73810,67008,6802,10.2,2010/07/20(15:00)
2010,07,19,74407,73810,65683,8127,12.4,2010/07/19(15:00)
2010,07,18,74407,72962,53048,19914,37.5,2010/07/18(21:00)
2010,07,17,74407,72067,56700,15367,27.1,2010/07/17(12:00)
2010,07,16,74407,71623,63439,8184,12.9,2010/07/16(15:00)
2010,07,15,74407,73358,64795,8563,13.2,2010/07/15(15:00)
2010,07,14,74407,73839,63985,9854,15.4,2010/07/14(15:00)
2010,07,13,74407,73868,63409,10459,16.5,2010/07/13(15:00)
2010,07,12,74407,73805,62649,11156,17.8,2010/07/12(15:00)
2010,07,11,74407,71918,50322,21596,42.9,2010/07/11(21:00)
2010,07,10,74407,72026,56927,15099,26.5,2010/07/10(12:00)
2010,07,09,74407,72953,63904,9049,14.2,2010/07/09(15:00)
2010,07,08,74407,72801,63493,9308,14.7,2010/07/08(15:00)
2010,07,07,74407,71285,64839,6446,9.9,2010/07/07(07:00)
2010,07,06,74407,71849,65025,6824,10.5,2010/07/06(15:00)
2010,07,05,74407,72195,64587,7608,11.8,2010/07/05(15:00)
2010,07,04,74407,72006,52044,19962,38.4,2010/07/04(21:00)
2010,07,03,74407,71769,56545,15224,26.9,2010/07/03(15:00)
2010,07,02,74407,72728,63277,9451,14.9,2010/07/02(15:00)
2010,07,01,74407,72754,63274,9480,15,2010/07/01(15:00)
2010,06,30,74407,72763,62044,10719,17.3,2010/06/30(15:00)
2010,06,29,74407,72343,62699,9644,15.4,2010/06/29(15:00)
2010,06,28,74407,72153,61810,10343,16.7,2010/06/28(15:00)
2010,06,27,74407,70617,49412,21205,42.9,2010/06/27(21:00)
2010,06,26,74407,71488,54224,17264,31.8,2010/06/26(12:00)
2010,06,25,74407,71565,62828,8737,13.9,2010/06/25(15:00)
2010,06,24,74407,71288,62130,9158,14.7,2010/06/24(15:00)
2010,06,23,74407,71246,60629,10617,17.5,2010/06/23(15:00)
2010,06,22,74407,71396,60265,11131,18.5,2010/06/22(15:00)
2010,06,21,74407,71088,61058,10030,16.4,2010/06/21(17:00)
2010,06,20,74407,70076,49737,20339,40.9,2010/06/20(21:00)
2010,06,19,74407,70626,54962,15664,28.5,2010/06/19(12:00)
2010,06,18,74407,70465,62479,7986,12.8,2010/06/18(15:00)
2010,06,17,74407,70005,62269,7736,12.4,2010/06/17(15:00)
2010,06,16,74407,69734,60091,9643,16,2010/06/16(15:00)
2010,06,15,74407,68403,61656,6747,10.9,2010/06/15(15:00)
2010,06,14,74407,68009,59693,8316,13.9,2010/06/14(15:00)
2010,06,13,74407,67481,49237,18244,37.1,2010/06/13(21:00)
2010,06,12,74407,67486,52380,15106,28.8,2010/06/12(12:00)
2010,06,11,74407,67509,60497,7012,11.6,2010/06/11(15:00)
2010,06,10,74407,67316,61464,5852,9.5,2010/06/10(15:00)
2010,06,09,74407,67054,60564,6490,10.7,2010/06/09(15:00)
2010,06,08,74407,66771,59341,7430,12.5,2010/06/08(17:00)
2010,06,07,74407,66816,59364,7452,12.6,2010/06/07(15:00)
2010,06,06,74407,65986,48278,17708,36.7,2010/06/06(21:00)
2010,06,05,74407,65237,52282,12955,24.8,2010/06/05(12:00)
2010,06,04,74407,65463,57021,8442,14.8,2010/06/04(15:00)
2010,06,03,74407,65557,56224,9333,16.6,2010/06/03(17:00)
2010,06,02,74407,66353,51954,14399,27.7,2010/06/02(21:00)
2010,06,01,74407,64558,54197,10361,19.1,2010/06/01(17:00)
2010,05,31,74407,64018,53838,10180,18.9,2010/05/31(15:00)
2010,05,30,74407,63879,46909,16970,36.2,2010/05/30(21:00)
2010,05,29,74407,63715,50137,13578,27.1,2010/05/29(12:00)
2010,05,28,74407,64507,54403,10104,18.6,2010/05/28(15:00)
2010,05,27,74407,64476,54253,10223,18.8,2010/05/27(21:00)
2010,05,26,74407,64079,54148,9931,18.3,2010/05/26(15:00)
2010,05,25,74407,63713,54352,9361,17.2,2010/05/25(11:00)
2010,05,24,74407,64376,54076,10300,19,2010/05/24(15:00)
2010,05,23,73673,65243,46849,18394,39.3,2010/05/23(23:00)
2010,05,22,73673,64564,48959,15605,31.9,2010/05/22(12:00)
2010,05,21,73673,65652,51089,14563,28.5,2010/05/21(21:00)
2010,05,20,73673,65579,55393,10186,18.4,2010/05/20(15:00)
2010,05,19,73673,64952,54308,10644,19.6,2010/05/19(15:00)
2010,05,18,73673,65153,55244,9909,17.9,2010/05/18(15:00)
2010,05,17,73673,64872,54482,10390,19.1,2010/05/17(15:00)
2010,05,16,73673,64832,46502,18330,39.4,2010/05/16(21:00)
2010,05,15,73673,63466,49725,13741,27.6,2010/05/15(11:00)
2010,05,14,73673,63917,53540,10377,19.4,2010/05/14(15:00)
2010,05,13,73673,64167,53707,10460,19.5,2010/05/13(21:00)
2010,05,12,73673,63467,53564,9903,18.5,2010/05/12(13:00)
2010,05,11,73673,63467,54209,9258,17.1,2010/05/11(21:00)
2010,05,10,73673,63967,53919,10048,18.6,2010/05/10(21:00)
2010,05,09,73673,64822,46677,18145,38.9,2010/05/09(21:00)
2010,05,08,73673,64308,49220,15088,30.7,2010/05/08(11:00)
2010,05,07,73673,64288,53512,10776,20.1,2010/05/07(11:00)
2010,05,06,73673,64845,54703,10142,18.5,2010/05/06(20:00)
2010,05,05,73673,64866,50631,14235,28.1,2010/05/05(21:00)
2010,05,04,73673,65002,54128,10874,20.1,2010/05/04(20:00)
2010,05,03,73673,65147,54328,10819,19.9,2010/05/03(20:00)
2010,05,02,73673,65730,47824,17906,37.4,2010/05/02(23:00)
2010,05,01,73673,66373,49267,17106,34.7,2010/05/01(01:00)
2010,04,30,73673,66437,55018,11419,20.8,2010/04/30(11:00)
2010,04,29,73673,66532,56313,10219,18.1,2010/04/29(11:00)
2010,04,28,73673,65956,58766,7190,12.2,2010/04/28(15:00)
2010,04,27,73673,64426,56387,8039,14.3,2010/04/27(20:00)
2010,04,26,73673,65997,56083,9914,17.7,2010/04/26(20:00)
2010,04,25,73673,65955,48521,17434,35.9,2010/04/25(23:00)
2010,04,24,73673,65635,51033,14602,28.6,2010/04/24(23:00)
2010,04,23,73673,66660,55370,11290,20.4,2010/04/23(11:00)
2010,04,22,73673,66539,56553,9986,17.7,2010/04/22(11:00)
2010,04,21,73673,66163,55520,10643,19.2,2010/04/21(20:00)
2010,04,21,73673,66163,55520,10643,19.2,2010/04/21(20:00)
2010,04,20,73673,66163,55078,11085,20.1,2010/04/20(20:00)
2010,04,19,73673,66281,55814,10467,18.8,2010/04/19(20:00)
2010,04,18,73673,66110,49721,16389,33,2010/04/18(23:00)
2010,04,17,73673,65931,52212,13719,26.3,2010/04/17(24:00)
2010,04,16,73673,64676,56590,8086,14.3,2010/04/16(11:00)
2010,04,15,73673,64862,58131,6731,11.6,2010/04/15(11:00)
2010,04,14,73673,64619,58304,6315,10.8,2010/04/14(20:00)
2010,04,13,73673,64537,58181,6356,10.9,2010/04/13(20:00)
2010,04,12,73673,64150,56017,8133,14.5,2010/04/12(11:00)
2010,04,11,73673,64719,48636,16083,33.1,2010/04/11(23:00)
2010,04,10,73470,64640,51203,13437,26.2,2010/04/10(11:00)
2010,04,09,73470,64561,55600,8961,16.1,2010/04/09(11:00)
2010,04,08,73470,65348,56916,8432,14.8,2010/04/08(11:00)
2010,04,07,73470,65116,56624,8492,15,2010/04/07(20:00)
2010,04,06,73470,64654,56978,7676,13.5,2010/04/06(11:00)
2010,04,05,73470,64464,55671,8793,15.8,2010/04/05(20:00)
2010,04,04,73470,63672,50063,13609,27.2,2010/04/04(23:00)
2010,04,03,73470,63738,53429,10309,19.3,2010/04/03(24:00)
2010,04,02,73470,65878,57662,8216,14.2,2010/04/02(11:00)
2010,04,01,73470,66370,58130,8240,14.2,2010/04/01(11:00)
2010,03,31,73470,66092,59738,6354,10.6,2010/03/31(11:00)
2010,03,30,73470,66887,58949,7938,13.5,2010/03/30(11:00)
2010,03,29,73470,66169,58571,7598,13,2010/03/29(11:00)
2010,03,28,73470,65767,51532,14235,27.6,2010/03/28(23:00)
2010,03,27,73470,66048,54334,11714,21.6,2010/03/27(11:00)
2010,03,26,73470,67762,60478,7284,12,2010/03/26(11:00)
2010,03,25,73470,67308,60204,7104,11.8,2010/03/25(20:00)
2010,03,24,73470,66934,58629,8305,14.2,2010/03/24(11:00)
2010,03,24,73470,66934,58629,8305,14.2,2010/03/24(11:00)
2010,03,23,73470,67187,61085,6102,10,2010/03/23(11:00)
2010,03,22,73470,67457,61342,6115,10,2010/03/22(17:00)
2010,03,21,73470,68240,52065,16175,31.1,2010/03/21(23:00)
2010,03,20,73470,67548,54215,13333,24.6,2010/03/20(24:00)
2010,03,19,73470,67228,60987,6241,10.2,2010/03/19(11:00)
2010,03,18,73470,67441,61895,5546,9,2010/03/18(11:00)
2010,03,17,73470,67364,60693,6671,11,2010/03/17(11:00)
2010,03,16,73470,67329,60522,6807,11.2,2010/03/16(11:00)
2010,03,15,73470,66977,59614,7363,12.4,2010/03/15(11:00)
2010,03,14,73470,65855,51175,14680,28.7,2010/03/14(01:00)
2010,03,13,73470,66136,54685,11451,20.9,2010/03/13(11:00)
2010,03,12,73470,68437,60238,8199,13.6,2010/03/12(11:00)
2010,03,11,73470,68510,61714,6796,11,2010/03/11(11:00)
2010,03,10,73470,68648,63520,5128,8.1,2010/03/10(11:00)
2010,03,09,73470,68115,61719,6396,10.4,2010/03/09(11:00)
2010,03,08,734700,68264,60869,7395,12.1,2010/03/08(11:00)
2010,03,07,73470,67141,52649,14492,27.5,2010/03/07(07:00)
2010,03,06,73470,67090,54973,12117,22,2010/03/06(24:00)
2010,03,05,73470,69019,59940,9079,15.1,2010/03/05(11:00)
2010,03,04,73470,69390,60678,8712,14.4,2010/03/04(12:00)
2010,03,03,73470,69378,60567,8811,14.5,2010/03/03(11:00)
2010,03,02,73470,69389,61058,8331,13.6,2010/03/02(11:00)
2010,03,01,73470,68719,54174,14545,26.8,2010/03/01(24:00)
2010,02,28,73470,68404,50703,17701,34.9,2010/02/28(24:00)
2010,02,27,73470,68945,53514,15431,28.8,2010/02/27(24:00)
2010,02,26,73470,69847,57875,11972,20.7,2010/02/26(12:00)
2010,02,25,73470,69285,58443,10842,18.6,2010/02/25(12:00)
2010,02,24,73470,69368,58871,10497,17.8,2010/02/24(11:00)
2010,02,23,73470,70136,60745,9391,15.5,2010/02/23(11:00)
2010,02,22,73470,70184,62072,8112,13.1,2010/02/22(11:00)
2010,02,21,73470,69099,53941,15158,28.1,2010/02/21(01:00)
2010,02,20,73470,69646,57670,11976,20.8,2010/02/20(11:00)
2010,02,19,73470,70957,64530,6427,10,2010/02/19(11:00)
2010,02,18,73470,71077,64717,6360,9.8,2010/02/18(11:00)
2010,02,17,73470,70591,63991,6600,10.3,2010/02/17(11:00)
2010,02,16,73470,71097,56551,14546,25.7,2010/02/16(24:00)
2010,02,15,73470,71807,51038,20769,40.7,2010/02/15(15:00)
2010,02,14,73470,72433,48762,23671,48.5,2010/02/14(24:00)
2010,02,13,73470,72725,53947,18778,34.8,2010/02/13(01:00)
2010,02,12,73470,73173,62160,11013,17.7,2010/02/12(12:00)
2010,02,11,73470,73126,64432,8694,13.5,2010/02/11(12:00)
2010,02,10,73470,73117,63648,9469,14.9,2010/02/10(11:00)
2010,02,09,73470,73196,64692,8504,13.1,2010/02/09(11:00)
2010,02,08,73470,73594,65554,8040,12.3,2010/02/08(11:00)
2010,02,07,73470,73160,56968,16192,28.4,2010/02/07(07:00)
2010,02,06,73470,73400,60583,12817,21.2,2010/02/06(11:00)
2010,02,05,73470,73400,66347,7053,10.6,2010/02/05(11:00)
2010,02,04,73470,73400,66878,6522,9.8,2010/02/04(11:00)
2010,02,03,73470,73013,67158,5855,8.7,2010/02/03(11:00)
2010,02,02,73470,73290,65362,7928,12.1,2010/02/02(11:00)
2010,02,01,73470,72520,64747,7773,12,2010/02/01(11:00)
2010,01,31,73470,73570,54660,18910,34.6,2010/01/31(24:00)
2010,01,30,73470,73965,58093,15872,27.3,2010/01/30(11:00)
2010,01,29,73470,73980,65033,8947,13.8,2010/01/29(11:00)
2010,01,28,73470,73730,63737,9993,15.7,2010/01/28(11:00)
2010,01,27,73470,73990,65585,8405,12.8,2010/01/27(11:00)
2010,01,26,73470,74520,66754,7766,11.6,2010/01/26(11:00)
2010,01,25,73470,74410,65677,8733,13.3,2010/01/25(19:00)
2010,01,24,73470,74651,56835,17816,31.3,2010/01/24(01:00)
2010,01,23,73470,74292,59704,14588,24.4,2010/01/23(24:00)
2010,01,22,73470,74651,66357,8294,12.5,2010/01/22(11:00)
2010,01,21,73470,73750,64783,8967,13.8,2010/01/21(19:00)
2010,01,20,73470,73687,63608,10079,15.8,2010/01/20(11:00)
2010,01,19,73470,73627,66095,7532,11.4,2010/01/19(11:00)
2010,01,18,73470,73018,67347,5671,8.4,2010/01/18(11:00)
2010,01,17,73470,72987,58140,14847,25.5,2010/01/17(01:00)
2010,01,16,73470,73621,61076,12545,20.5,2010/01/16(01:00)
2010,01,15,73470,73454,68539,4915,7.2,2010/01/15(11:00)
2010,01,14,73470,74014,68937,5077,7.4,2010/01/14(11:00)
2010,01,13,73470,73722,68963,4759,6.9,2010/01/13(12:00)
2010,01,12,73470,72957,68758,4199,6.1,2010/01/12(11:00)
2010,01,11,73470,73430,68202,5228,7.7,2010/01/11(12:00)
2010,01,10,73470,73604,57900,15704,27.1,2010/01/10(01:00)
2010,01,09,73470,72328,61277,11051,18,2010/01/09(12:00)
2010,01,08,73470,72963,68555,4408,6.4,2010/01/08(11:00)
2010,01,07,73470,72963,68273,4690,6.9,2010/01/07(11:00)
2010,01,06,73470,72580,67855,4725,7,2010/01/06(12:00)
2010,01,05,73470,72770,66901,5869,8.8,2010/01/05(18:00)
2010,01,04,73470,72688,66149,6539,9.9,2010/01/04(12:00)
2010,01,03,73470,71958,55581,16377,29.5,2010/01/03(24:00)
2010,01,02,73470,71953,55470,16483,29.7,2010/01/02(24:00)
2010,01,01,73470,72003,56391,15612,27.7,2010/01/01(01:00)
2009,12,31,73470,72336,63023,9313,14.8,2009/12/31(11:00)
2009,12,30,73470,72344,64103,8241,12.9,2009/12/30(12:00)
2009,12,29,73470,71569,66175,5394,8.2,2009/12/29(11:00)
2009,12,28,73470,71109,66250,4859,7.3,2009/12/28(18:00)
2009,12,27,73470,71100,56908,14192,24.9,2009/12/27(24:00)
2009,12,26,73470,70900,57698,13202,22.9,2009/12/26(24:00)
2009,12,25,73470,71335,56855,14480,25.5,2009/12/25(24:00)
2009,12,24,73470,70343,63089,7254,11.5,2009/12/24(11:00)
2009,12,23,73310,70390,62605,7785,12.4,2009/12/23(11:00)
2009,12,22,73310,70589,64988,5601,8.6,2009/12/22(11:00)
2009,12,21,73310,70883,66430,4453,6.7,2009/12/21(18:00)
2009,12,20,73310,70303,57317,12986,22.7,2009/12/20(01:00)
2009,12,19,73310,70195,60368,9827,16.3,2009/12/19(12:00)
2009,12,18,73310,72071,66797,5274,7.9,2009/12/18(18:00)
2009,12,17,73310,71641,66619,5022,7.5,2009/12/17(18:00)
2009,12,16,73310,71416,65438,5978,9.1,2009/12/16(18:00)
2009,12,15,73310,71821,64991,6830,10.5,2009/12/15(18:00)
2009,12,14,73310,71821,63035,8786,13.9,2009/12/14(18:00)
2009,12,13,73310,71414,53008,18406,34.7,2009/12/13(24:00)
2009,12,12,73310,70783,54639,16144,29.5,2009/12/12(24:00)
2009,12,11,73310,71446,60076,11370,18.9,2009/12/11(18:00)
2009,12,10,73310,71604,61752,9852,16,2009/12/10(18:00)
2009,12,09,73310,71683,62766,8917,14.2,2009/12/09(11:00)
2009,12,08,73310,71647,63512,8135,12.8,2009/12/08(18:00)
2009,12,07,73310,71372,63292,8080,12.8,2009/12/07(18:00)
2009,12,06,73310,71393,54280,17113,31.5,2009/12/06(24:00)
2009,12,05,73310,71104,56513,14591,25.8,2009/12/05(24:00)
2009,12,04,73310,71103,60150,10953,18.2,2009/12/04(10:00)
2009,12,03,73310,71263,61007,10256,16.8,2009/12/03(18:00)
2009,12,02,73310,71287,59689,11598,19.4,2009/12/02(11:00)
2009,12,01,73310,71416,59636,11780,19.8,2009/12/01(18:00)
2009,11,30,73310,71426,59776,11650,19.5,2009/11/30(19:00)
2009,11,29,73310,70975,51347,19628,38.2,2009/11/29(24:00)
2009,11,28,73310,71166,53523,17643,33,2009/11/28(24:00)
2009,11,27,73310,71075,59078,11997,20.3,2009/11/27(18:00)
2009,11,26,73310,71184,59278,11906,20.1,2009/11/26(19:00)
2009,11,25,73310,71269,60453,10816,17.9,2009/11/25(11:00)
2009,11,24,73146,71178,59548,11630,19.5,2009/11/24(19:00)
2009,11,23,73146,70886,60295,10591,17.6,2009/11/23(19:00)
2009,11,22,73146,68658,52517,16141,30.7,2009/11/22(01:00)
2009,11,21,73146,68554,55343,13211,23.9,2009/11/21(24:00)
2009,11,20,73146,68809,61513,7296,11.9,2009/11/20(11:00)
2009,11,19,73146,69286,61375,7911,12.9,2009/11/19(19:00)
2009,11,18,73146,69092,61941,7151,11.5,2009/11/18(11:00)
2009,11,17,73146,68901,62315,6586,10.6,2009/11/17(19:00)
2009,11,16,73146,68117,61843,6274,10.1,2009/11/16(18:00)
2009,11,15,73146,68150,51343,16807,32.7,2009/11/15(24:00)
2009,11,14,73146,68903,52533,16370,31.2,2009/11/14(24:00)
2009,11,13,73146,68868,56464,12404,22,2009/11/13(19:00)
2009,11,12,73146,68868,56798,12070,21.3,2009/11/12(19:00)
2009,11,11,73146,68490,56084,12406,22.1,2009/11/11(19:00)
2009,11,10,73146,68228,55965,12263,21.9,2009/11/10(19:00)
2009,11,09,73146,68283,55501,12782,23,2009/11/09(19:00)
2009,11,08,73146,68177,47440,20737,43.7,2009/11/08(23:00)
2009,11,07,73146,66997,48893,18104,37,2009/11/07(19:00)
2009,11,06,73146,66997,55063,11934,21.7,2009/11/06(19:00)
2009,11,05,73146,66988,55675,11313,20.3,2009/11/05(19:00)
2009,11,04,73146,65939,56250,9689,17.2,2009/11/04(19:00)
2009,11,03,73146,66463,58414,8049,13.8,2009/11/03(19:00)
2009,11,02,73146,65484,57910,7574,13.1,2009/11/02(19:00)
2009,11,01,73146,63811,46865,16946,36.2,2009/11/01(23:00)
2009,10,31,73146,64321,48315,16006,33.1,2009/10/31(19:00)
2009,10,30,73146,65638,54501,11137,20.4,2009/10/30(19:00)
2009,10,29,73146,65535,55012,10523,19.1,2009/10/29(19:00)
2009,10,28,73146,66470,54582,11888,21.8,2009/10/28(19:00)
2009,10,27,73146,67255,55103,12152,22.1,2009/10/27(19:00)
2009,10,26,73146,67255,54954,12301,22.4,2009/10/26(19:00)
2009,10,25,73146,66261,46506,19755,42.5,2009/10/25(23:00)
2009,10,24,73146,65211,48221,16990,35.2,2009/10/24(19:00)
2009,10,23,73146,67509,54448,13061,24,2009/10/23(19:00)
2009,10,22,73146,67487,55068,12419,22.6,2009/10/22(19:00)
2009,10,21,73146,66967,54101,12866,23.8,2009/10/21(19:00)
2009,10,20,73146,67205,54543,12662,23.2,2009/10/20(19:00)
2009,10,19,73146,67205,54576,12629,23.1,2009/10/19(19:00)
2009,10,18,73146,65423,46121,19302,41.9,2009/10/18(23:00)
2009,10,17,73146,65846,48159,17687,36.7,2009/10/17(19:00)
2009,10,16,73146,66196,54176,12020,22.2,2009/10/16(19:00)
2009,10,15,73146,66327,54511,11816,21.7,2009/10/15(19:00)
2009,10,14,73146,66627,53812,12815,23.8,2009/10/14(19:00)
2009,10,13,73146,66039,54584,11455,21,2009/10/13(19:00)
2009,10,12,73146,66398,54006,12392,22.9,2009/10/12(19:00)
2009,10,11,73146,66784,46152,20632,44.7,2009/10/11(20:00)
2009,10,10,73146,66522,48378,18144,37.5,2009/10/10(20:00)
2009,10,09,73146,68332,53558,14774,27.6,2009/10/09(19:00)
2009,10,07,73146,67491,53223,14268,26.8,2009/10/07(19:00)
2009,10,06,73146,68264,52468,15796,30.1,2009/10/06(20:00)
2009,10,05,73146,67412,46447,20965,45.1,2009/10/05(20:00)
2009,10,04,73146,68090,39607,28483,71.9,2009/10/04(20:00)
2009,10,03,73146,68090,37110,30980,83.5,2009/10/03(23:00)
2009,10,02,73146,68090,40891,27199,66.5,2009/10/02(01:00)
2009,10,01,73146,68493,51529,16964,32.9,2009/10/01(12:00)
2009,09,30,73372,69747,55410,14337,25.9,2009/09/30(15:00)
2009,09,29,73372,69374,55733,13641,24.5,2009/09/29(20:00)
2009,09,28,73372,69374,55590,13784,24.8,2009/09/28(20:00)
2009,09,27,73372,68378,47568,20810,43.7,2009/09/27(20:00)
2009,09,26,73372,68824,50805,18019,35.5,2009/09/26(15:00)
2009,09,25,73372,69003,55228,13775,24.9,2009/09/25(15:00)
2009,09,24,73372,68310,55939,12371,22.1,2009/09/24(20:00)
2009,09,23,73372,67839,55676,12163,21.8,2009/09/23(19:00)
2009,09,22,73372,68331,55412,12919,23.3,2009/09/22(20:00)
2009,09,21,73372,67827,55221,12606,22.8,2009/09/21(16:00)
2009,09,20,73372,66489,46946,19543,41.6,2009/09/20(20:00)
2009,09,19,73372,65822,50143,15679,31.3,2009/09/19(14:00)
2009,09,18,73372,68053,56575,11478,20.3,2009/09/18(15:00)
2009,09,17,73372,68053,55850,12203,21.8,2009/09/17(20:00)
2009,09,16,73372,67363,55970,11393,20.4,2009/09/16(15:00)
2009,09,15,73372,67611,55619,11992,21.6,2009/09/15(20:00)
2009,09,14,73372,67611,55318,12293,22.2,2009/09/14(20:00)
2009,09,13,73372,65799,47118,18681,39.6,2009/09/13(20:00)
2009,09,12,73372,66462,50159,16303,32.5,2009/09/12(12:00)
2009,09,11,733720,67882,56799,11083,19.5,2009/09/11(15:00)
2009,09,10,73372,68185,58242,9943,17.1,2009/09/10(15:00)
2009,09,09,73372,67750,59138,8612,14.6,2009/09/09(15:00)
2009,09,08,73372,66557,59386,7171,12.1,2009/09/08(15:00)
2009,09,07,73372,67097,60624,6473,10.7,2009/09/07(15:00)
2009,09,06,73372,66109,49616,16493,33.2,2009/09/06(20:00)
2009,09,05,73372,65528,53402,12126,22.7,2009/09/05(15:00)
2009,09,04,73372,67845,58476,9369,16,2009/09/04(15:00)
2009,09,03,73372,68106,58194,9912,17,2009/09/03(15:00)
2009,09,02,73372,68106,57800,10306,17.8,2009/09/02(15:00)
2009,09,01,73372,68213,57233,10980,19.2,2009/09/01(15:00)
2009,08,31,73372,70362,56461,13901,24.6,2009/08/31(15:00)
2009,08,30,73372,69216,46285,22931,49.5,2009/08/30(21:00)
2009,08,29,73372,69126,51791,17335,33.5,2009/08/29(12:00)
2009,08,28,73372,70764,61414,9350,15.2,2009/08/28(15:00)
2009,08,27,73372,70690,60444,10246,17,2009/08/27(15:00)
2009,08,26,73372,71070,60319,10751,17.8,2009/08/26(15:00)
2009,08,25,73372,71070,60971,10099,16.6,2009/08/25(15:00)
2009,08,24,73372,71070,61245,9825,16,2009/08/24(15:00)
2009,08,23,73372,70013,49661,20352,41,2009/08/23(21:00)
2009,08,22,73372,70295,53552,16743,31.3,2009/08/22(15:00)
2009,08,21,73372,72990,60753,12237,20.1,2009/08/21(15:00)
2009,08,20,73372,72990,62753,10237,16.3,2009/08/20(15:00)
2009,08,19,73372,72632,63212,9420,14.9,2009/08/19(15:00)
2009,08,18,73372,72367,62677,9690,15.5,2009/08/18(15:00)
2009,08,17,73372,72979,61411,11568,18.8,2009/08/17(15:00)
2009,08,16,73372,72002,50351,21651,43,2009/08/16(21:00)
2009,08,15,73372,72002,52995,19007,35.9,2009/08/15(15:00)
2009,08,14,73372,72990,60730,12260,20.2,2009/08/14(15:00)
2009,08,13,73372,72990,60699,12291,20.2,2009/08/13(15:00)
2009,08,12,73372,72990,58564,14426,24.6,2009/08/12(15:00)
2009,08,11,73372,72990,57619,15371,26.7,2009/08/11(15:00)
2009,08,10,73372,72990,60492,12498,20.7,2009/08/10(15:00)
2009,08,09,73372,72990,50348,22642,45,2009/08/09(21:00)
2009,08,08,73372,72990,52192,20798,39.8,2009/08/08(15:00)
2009,08,07,73372,72082,57052,15030,26.3,2009/08/07(15:00)
2009,08,06,73372,72082,57014,15068,26.4,2009/08/06(15:00)
2009,08,05,73373,72969,54900,18069,32.9,2009/08/05(15:00)
2009,08,04,73372,72969,52668,20301,38.5,2009/08/04(15:00)
2009,08,03,73372,72969,49338,23631,47.9,2009/08/03(15:00)
2009,08,02,73372,72002,46763,25239,54,2009/08/02(21:00)
2009,08,01,73372,71652,47347,24305,51.3,2009/08/01(21:00)
2009,07,31,73372,72002,56611,15391,27.2,2009/07/31(15:00)
2009,07,30,73372,72953,58389,14564,24.9,2009/07/30(15:00)
2009,07,29,73372,72953,57923,15030,25.9,2009/07/29(15:00)
2009,07,28,73372,72953,56991,15962,28,2009/07/28(15:00)
2009,07,27,73372,72953,57585,15368,26.7,2009/07/27(15:00)
2009,07,26,73372,71050,46625,24425,52.4,2009/07/26(21:00)
2009,07,25,73372,71050,49542,21508,43.4,2009/07/25(12:00)
2009,07,24,73372,72761,57224,15537,27.2,2009/07/24(15:00)
2009,07,23,73372,72761,58743,14018,23.9,2009/07/23(15:00)
2009,07,22,73372,72761,58226,14535,25,2009/07/22(15:00)
2009,07,21,73372,72761,59550,13211,22.2,2009/07/21(15:00)
2009,07,20,73372,72113,60801,11312,18.6,2009/07/20(15:00)
2009,07,19,73372,71052,49323,21729,44.1,2009/07/19(21:00)
2009,07,18,73372,70402,53370,17032,31.9,2009/07/18(12:00)
2009,07,17,73372,72040,59107,12933,21.9,2009/07/17(15:00)
2009,07,16,73372,71490,59022,12468,21.1,2009/07/16(15:00)
2009,07,15,73372,71385,56502,14883,26.3,2009/07/15(15:00)
2009,07,14,73372,71511,60415,11096,18.4,2009/07/14(15:00)
2009,07,13,73372,71511,58453,13058,22.3,2009/07/13(15:00)
2009,07,12,73372,69924,47301,22623,47.8,2009/07/12(21:00)
2009,07,11,73372,69624,51127,18497,36.2,2009/07/11(12:00)
2009,07,10,73372,71118,58622,12496,21.3,2009/07/10(15:00)
2009,07,09,73372,70525,58746,11779,20.1,2009/07/09(15:00)
2009,07,08,73372,70609,60557,10052,16.6,2009/07/08(15:00)
2009,07,07,73372,70609,57469,13140,22.9,2009/07/07(15:00)
2009,07,05,73372,69628,47811,21817,45.6,2009/07/05(21:00)
2009,07,04,73372,69628,50224,19404,38.6,2009/07/04(15:00)
2009,07,03,73372,69123,56383,12740,22.6,2009/07/03(15:00)
2009,07,02,73372,68859,55640,13219,23.8,2009/07/02(15:00)
2009,07,01,73372,69323,56781,12542,22.1,2009/07/01(14:00)
2009,06,30,73697,69656,58911,10745,18.2,2009/06/30(15:00)
2009,06,29,73697,68363,60129,8234,13.7,2009/06/29(15:00)
2009,06,28,73697,68683,48267,20416,42.3,2009/06/28(21:00)
2009,06,27,73697,68158,52277,15881,30.4,2009/06/27(15:00)
2009,06,26,73697,68283,58901,9382,15.9,2009/06/26(15:00)
2009,06,25,73697,68072,58049,10023,17.3,2009/06/25(15:00)
2009,06,24,73697,68172,57728,10444,18.1,2009/06/24(15:00)
2009,06,23,73697,68338,57052,11286,19.8,2009/06/23(15:00)
2009,06,22,73697,67655,55864,11791,21.1,2009/06/22(15:00)
2009,06,21,73697,67802,48082,19720,41,2009/06/21(21:00)
2009,06,20,73697,67151,50328,16823,33.4,2009/06/20(12:00)
2009,06,19,73697,68099,58037,10062,17.3,2009/06/19(15:00)
2009,06,18,73697,68353,56457,11896,21.1,2009/06/18(15:00)
2009,06,17,73697,68012,54583,13429,24.6,2009/06/17(15:00)
2009,06,16,73697,68548,54676,13872,25.4,2009/06/16(15:00)
2009,06,15,73697,68313,53958,14355,26.6,2009/06/15(15:00)
2009,06,14,73697,68052,44854,23198,51.7,2009/06/14(21:00)
2009,06,13,73188,67725,47722,20003,41.9,2009/06/13(12:00)
2009,06,12,73188,68132,53345,14787,27.7,2009/06/12(15:00)
2009,06,11,73188,68046,53343,14703,27.6,2009/06/11(15:00)
2009,06,10,73188,68209,53202,15007,28.2,2009/06/10(15:00)
2009,06,09,73188,68272,52890,15382,29.1,2009/06/09(15:00)
2009,06,08,73148,68169,53265,14904,28,2009/06/08(15:00)
2009,06,07,73148,67340,44363,22977,51.8,2009/06/07(21:00)
2009,06,06,73148,66663,46358,20305,43.8,2009/06/06(15:00)
2009,06,05,73148,67020,53327,13693,25.7,2009/06/05(15:00)
2009,06,04,73148,66364,52843,13521,25.6,2009/06/04(15:00)
2009,06,03,73148,65041,52061,12980,24.9,2009/06/03(15:00)
2009,06,02,73148,67279,53777,13502,25.1,2009/06/02(15:00)
2009,06,01,73148,67479,52570,14909,28.4,2009/06/01(15:00)
2009,05,31,73148,67800,43278,24522,56.7,2009/05/31(21:00)
2009,05,30,73148,67257,45709,21548,47.1,2009/05/30(15:00)
2009,05,29,73148,67036,52423,14613,27.9,2009/05/29(15:00)
2009,05,28,73148,67546,53065,14481,27.3,2009/05/28(15:00)
2009,05,27,73148,67760,53197,14563,27.4,2009/05/27(15:00)
2009,05,26,72629,67145,53033,14112,26.6,2009/05/26(15:00)
2009,05,25,72629,67149,51954,15195,29.2,2009/05/25(15:00)
2009,05,24,72629,66887,43964,22923,52.1,2009/05/24(21:00)
2009,05,23,726290,66748,46280,20468,44.2,2009/05/23(12:00)
2009,05,22,72629,67548,50554,16994,33.6,2009/05/22(15:00)
2009,05,21,72629,67941,51324,16617,32.4,2009/05/21(15:00)
2009,05,20,72629,66056,51936,14120,27.2,2009/05/20(15:00)
2009,05,19,72629,66776,51397,15379,29.9,2009/05/19(15:00)
2009,05,18,72629,66892,50268,16624,33.1,2009/05/18(21:00)
2009,05,17,72629,66351,44125,22226,50.4,2009/05/17(23:00)
2009,05,16,72629,65963,46813,19150,40.9,2009/05/16(11:00)
2009,05,15,72629,66289,51309,14980,29.2,2009/05/15(15:00)
2009,05,14,72629,65764,51338,14426,28.1,2009/05/14(15:00)
2009,05,13,72629,65448,50794,14654,28.8,2009/05/13(11:00)
2009,05,12,72629,64893,51589,13304,25.8,2009/05/12(11:00)
2009,05,11,72629,64658,51536,13122,25.5,2009/05/11(15:00)
2009,05,10,72629,63609,44429,19180,43.2,2009/05/10(21:00)
2009,05,09,72629,64621,46862,17759,37.9,2009/05/09(12:00)
2009,05,08,72629,64521,51616,12905,25,2009/05/08(15:00)
2009,05,07,72629,64131,50939,13192,25.9,2009/05/07(15:00)
2009,05,06,72629,64670,50629,14041,27.7,2009/05/06(15:00)
2009,05,05,72629,64661,45938,18723,40.8,2009/05/05(22:00)
2009,05,04,72629,64661,46825,17836,38.1,2009/05/04(21:00)
2009,05,03,72629,65011,43294,21717,50.2,2009/05/03(23:00)
2009,05,02,72629,64244,44498,19746,44.4,2009/05/02(23:00)
2009,05,01,72629,65034,44695,20339,45.5,2009/05/01(23:00)
2009,04,30,72629,64894,49883,15011,30.1,2009/04/30(11:00)
2009,04,29,72629,64272,50407,13865,27.5,2009/04/29(11:00)
2009,04,28,72629,64272,50488,13784,27.3,2009/04/28(20:00)
2009,04,27,72629,63753,50850,12903,25.4,2009/04/27(20:00)
2009,04,26,72629,62548,46033,16515,35.9,2009/04/26(23:00)
2009,04,25,72629,62296,47911,14385,30,2009/04/25(24:00)
2009,04,24,72629,62390,51051,11339,22.2,2009/04/24(20:00)
2009,04,23,72629,63078,50994,12084,23.7,2009/04/23(20:00)
2009,04,22,72629,62704,51114,11590,22.7,2009/04/22(20:00)
2009,04,21,72629,62805,51821,10984,21.2,2009/04/21(20:00)
2009,04,20,72629,63853,51592,12261,23.8,2009/04/20(15:00)
2009,04,19,72629,63252,44250,19002,42.9,2009/04/19(23:00)
2009,04,18,72629,62344,46026,16318,35.5,2009/04/18(23:00)
2009,04,17,72629,64437,50395,14042,27.9,2009/04/17(11:00)
2009,04,16,72629,64654,52041,12613,24.2,2009/04/16(11:00)
2009,04,15,72629,65150,52067,13083,25.1,2009/04/15(17:00)
2009,04,14,72629,65343,51223,14120,27.6,2009/04/14(20:00)
2009,04,13,72629,65207,51012,14195,27.8,2009/04/13(20:00)
2009,04,12,72629,65105,44195,20910,47.3,2009/04/12(23:00)
2009,04,11,72629,64831,45953,18878,41.1,2009/04/11(23:00)
2009,04,10,72629,66420,50469,15951,31.6,2009/04/10(11:00)
2009,04,09,72629,65475,51342,14133,27.5,2009/04/09(20:00)
2009,04,08,72629,65509,50873,14636,28.8,2009/04/08(20:00)
2009,04,07,72629,65412,51864,13548,26.1,2009/04/07(11:00)
2009,04,06,72629,65456,52194,13262,25.4,2009/04/06(11:00)
2009,04,05,72629,65503,46563,18940,40.7,2009/04/05(23:00)
2009,04,04,72629,65417,48270,17147,35.5,2009/04/04(24:00)
2009,04,03,72629,64944,53216,11728,22,2009/04/03(11:00)
2009,04,02,72629,64944,53453,11491,21.5,2009/04/02(11:00)
2009,04,01,72629,64373,54063,10310,19.1,2009/04/01(11:00)
2009,03,31,72480,65335,53220,12115,22.8,2009/03/31(11:00)
2009,03,30,72480,66211,53448,12763,23.9,2009/03/30(11:00)
2009,03,29,72480,66471,47295,19176,40.5,2009/03/29(23:00)
2009,03,28,72480,66196,49470,16726,33.8,2009/03/28(24:00)
2009,03,27,72480,65978,54917,11061,20.1,2009/03/27(11:00)
2009,03,26,72480,65614,55822,9792,17.5,2009/03/26(11:00)
2009,03,25,72480,65652,55075,10577,19.2,2009/03/25(11:00)
2009,03,24,72480,65744,54655,11089,20.3,2009/03/24(20:00)
2009,03,23,72480,66114,53588,12526,23.4,2009/03/23(20:00)
2009,03,22,72480,65288,46749,18539,39.7,2009/03/22(23:00)
2009,03,21,72480,66388,47092,19296,41,2009/03/21(23:00)
2009,03,20,72480,66911,51983,14928,28.7,2009/03/20(11:00)
2009,03,19,72480,66805,52109,14696,28.2,2009/03/19(20:00)
2009,03,18,72480,66235,52245,13990,26.8,2009/03/18(11:00)
2009,03,17,72480,66471,53677,12794,23.8,2009/03/17(10:00)
2009,03,16,72480,66444,54969,11475,20.9,2009/03/16(11:00)
2009,03,15,72480,65919,49085,16834,34.3,2009/03/15(01:00)
2009,03,14,72480,66535,52205,14330,27.4,2009/03/14(01:00)
2009,03,13,72480,66369,56322,10047,17.8,2009/03/13(11:00)
2009,03,12,72480,66369,55223,11146,20.2,2009/03/12(10:00)
2009,03,11,72480,65993,56506,9487,16.8,2009/03/11(11:00)
2009,03,10,72480,65907,55381,10526,19,2009/03/10(11:00)
2009,03,09,72480,66107,55402,10705,19.3,2009/03/09(11:00)
2009,03,08,72480,65620,48870,16750,34.3,2009/03/08(24:00)
2009,03,07,72480,66720,51479,15241,29.6,2009/03/07(01:00)
2009,03,06,72480,66910,55993,10917,19.5,2009/03/06(11:00)
2009,03,05,72480,66910,56488,10422,18.4,2009/03/05(11:00)
2009,03,04,72480,66911,56892,10019,17.6,2009/03/04(11:00)
2009,03,03,72480,66650,58047,8603,14.8,2009/03/03(11:00)
2009,03,02,72480,67359,55584,11775,21.2,2009/03/02(11:00)
2009,03,01,72480,67821,48955,18866,38.5,2009/03/01(24:00)
2009,02,27,72480,68015,55303,12712,23,2009/02/27(11:00)
2009,02,26,72480,68049,55960,12089,21.6,2009/02/26(11:00)
2009,02,25,72480,67768,54976,12792,23.3,2009/02/25(11:00)
2009,02,23,72480,67811,56655,11156,19.7,2009/02/23(11:00)
2009,02,22,72480,67607,50234,17373,34.6,2009/02/22(01:00)
2009,02,21,72480,68386,54137,14249,26.3,2009/02/21(01:00)
2009,02,20,72480,68079,58205,9874,17,2009/02/20(11:00)
2009,02,19,72480,68124,59123,9001,15.2,2009/02/19(11:00)
2009,02,18,72480,68410,59360,9050,15.2,2009/02/18(11:00)
2009,02,17,72480,68667,59849,8818,14.7,2009/02/17(11:00)
2009,02,16,72480,68948,59293,9655,16.3,2009/02/16(12:00)
2009,02,15,72480,67848,50996,16852,33,2009/02/15(24:00)
2009,02,14,72480,67336,49870,17466,35,2009/02/14(24:00)
2009,02,13,72480,68292,53346,14946,28,2009/02/13(11:00)
2009,02,12,72480,68399,55577,12822,23.1,2009/02/12(10:00)
2009,02,11,72480,67521,55997,11524,20.6,2009/02/11(11:00)
2009,02,10,72480,67440,56561,10879,19.2,2009/02/10(11:00)
2009,02,09,72480,68927,56477,12450,22,2009/02/09(11:00)
2009,02,08,72480,67267,49128,18139,36.9,2009/02/08(24:00)
2009,02,07,72480,67635,50784,16851,33.2,2009/02/07(01:00)
2009,02,06,72480,68160,56551,11609,20.5,2009/02/06(11:00)
2009,02,05,72480,68662,56451,12211,21.6,2009/02/05(11:00)
2009,02,04,72480,68662,56833,11829,20.8,2009/02/04(11:00)
2009,02,03,72480,69714,56138,13576,24.2,2009/02/03(11:00)
2009,02,02,72480,69678,56736,12942,22.8,2009/02/02(11:00)
2009,02,01,72480,68218,48964,19254,39.3,2009/02/01(24:00)
2009,01,31,72480,69532,50216,19316,38.5,2009/01/31(24:00)
2009,01,30,72480,69436,56144,13292,23.7,2009/01/30(11:00)
2009,01,29,72480,69396,56164,13232,23.6,2009/01/29(11:00)
2009,01,28,72480,69105,50578,18527,36.6,2009/01/28(24:00)
2009,01,27,72480,67895,46881,21014,44.8,2009/01/27(24:00)
2009,01,26,72480,67345,45285,22060,48.7,2009/01/26(24:00)
2009,01,25,72480,68445,50320,18125,36,2009/01/25(01:00)
2009,01,24,72480,69170,54653,14517,26.6,2009/01/24(01:00)
2009,01,23,72480,69461,59718,9743,16.3,2009/01/23(12:00)
2009,01,22,72480,70302,58567,11735,20,2009/01/22(11:00)
2009,01,21,72480,70262,59758,10504,17.6,2009/01/21(11:00)
2009,01,20,72480,70217,59848,10369,17.3,2009/01/20(11:00)
2009,01,19,72480,70241,59680,10561,17.7,2009/01/19(11:00)
2009,01,18,72480,69321,51885,17436,33.6,2009/01/18(24:00)
2009,01,17,72480,67833,55500,12333,22.2,2009/01/17(01:00)
2009,01,16,72480,69177,61837,7340,11.9,2009/01/16(12:00)
2009,01,15,72480,69404,62529,6875,11,2009/01/15(11:00)
2009,01,14,72480,68258,62245,6013,9.7,2009/01/14(11:00)
2009,01,13,72480,68768,62269,6499,10.4,2009/01/13(11:00)
2009,01,12,72480,68748,62645,6103,9.7,2009/01/12(12:00)
2009,01,11,72480,68178,53691,14487,27,2009/01/11(24:00)
2009,01,10,72480,67483,55131,12352,22.4,2009/01/10(24:00)
2009,01,09,72480,68584,59885,8699,14.5,2009/01/09(11:00)
2009,01,08,72480,68758,59984,8774,14.6,2009/01/08(11:00)
2009,01,07,72480,68527,59337,9190,15.5,2009/01/07(11:00)
2009,01,06,72480,68105,59647,8458,14.2,2009/01/06(11:00)
2009,01,05,72480,68715,58542,10173,17.4,2009/01/05(11:00)
2009,01,04,72480,68190,50030,18160,36.3,2009/01/04(24:00)
2009,01,03,72480,68188,50753,17435,34.4,2009/01/03(24:00)
2009,01,02,72480,68188,51611,16577,32.1,2009/01/02(24:00)
2009,01,01,72480,68242,48935,19307,39.5,2009/01/01(01:00)
2008,12,31,72490,68857,52857,16000,30.3,2008/12/31(11:00)
2008,12,30,72490,68778,54279,14499,26.7,2008/12/30(11:00)
2008,12,29,72490,67908,54390,13518,24.9,2008/12/29(12:00)
2008,12,28,72490,67224,48901,18323,37.5,2008/12/28(24:00)
2008,12,27,71989,67424,50870,16554,32.5,2008/12/27(24:00)
2008,12,26,71989,68461,55113,13348,24.2,2008/12/26(11:00)
2008,12,25,71989,68103,51739,16364,31.6,2008/12/25(24:00)
2008,12,24,71989,68703,56856,11847,20.8,2008/12/24(11:00)
2008,12,23,71989,68757,57634,11123,19.3,2008/12/23(11:00)
2008,12,22,71989,69627,58636,10991,18.7,2008/12/22(18:00)
2008,12,21,71989,68482,50362,18120,36,2008/12/21(24:00)
2008,12,20,71989,67640,50921,16719,32.8,2008/12/20(24:00)
2008,12,19,71989,68219,56927,11292,19.8,2008/12/19(11:00)
2008,12,18,71989,67748,56081,11667,20.8,2008/12/18(11:00)
2008,12,17,71989,68225,55973,12252,21.9,2008/12/17(11:00)
2008,12,16,71989,69021,57017,12004,21.1,2008/12/16(11:00)
2008,12,15,71989,68773,57043,11730,20.6,2008/12/15(11:00)
2008,12,14,71486,67057,50053,17004,34,2008/12/14(24:00)
2008,12,13,71486,66549,51162,15387,30.1,2008/12/13(24:00)
2008,12,12,71486,67980,55350,12630,22.8,2008/12/12(10:00)
2008,12,11,71486,68626,55168,13458,24.4,2008/12/11(18:00)
2008,12,10,71486,68922,54907,14015,25.5,2008/12/10(10:00)
2008,12,09,71486,68629,56160,12469,22.2,2008/12/09(11:00)
2008,12,08,71486,67844,58120,9724,16.7,2008/12/08(11:00)
2008,12,07,71486,66573,51494,15079,29.3,2008/12/07(01:00)
2008,12,06,71486,65863,54297,11566,21.3,2008/12/06(24:00)
2008,12,05,71486,66954,58476,8478,14.5,2008/12/05(18:00)
2008,12,04,71486,66359,55230,11129,20.2,2008/12/04(11:00)
2008,12,03,71486,65595,54992,10603,19.3,2008/12/03(10:00)
2008,12,02,71486,66227,54121,12106,22.4,2008/12/02(11:00)
2008,12,01,71486,66666,54708,11958,21.9,2008/12/01(11:00)
2008,11,30,70532,66510,48331,18179,37.6,2008/11/30(24:00)
2008,11,29,70532,66653,50352,16301,32.4,2008/11/29(24:00)
2008,11,28,70532,65492,54036,11456,21.2,2008/11/28(11:00)
2008,11,27,70532,65471,55778,9693,17.4,2008/11/27(18:00)
2008,11,26,70532,64949,54918,10031,18.3,2008/11/26(11:00)
2008,11,25,70532,65305,55377,9928,17.9,2008/11/25(11:00)
2008,11,24,70532,65382,55482,9900,17.8,2008/11/24(18:00)
2008,11,23,70532,64903,47759,17144,35.9,2008/11/23(24:00)
2008,11,22,70532,65282,51154,14128,27.6,2008/11/22(01:00)
2008,11,21,70532,66499,55584,10915,19.6,2008/11/21(18:00)
2008,11,20,70532,66372,57842,8530,14.7,2008/11/20(11:00)
2008,11,19,70532,65095,57764,7331,12.7,2008/11/19(18:00)
2008,11,18,70532,65095,56698,8397,14.8,2008/11/18(18:00)
2008,11,17,70532,65095,54182,10913,20.1,2008/11/17(19:00)
2008,11,16,70532,64057,45711,18346,40.1,2008/11/16(23:00)
2008,11,15,70532,63653,46763,16890,36.1,2008/11/15(24:00)
2008,11,14,70532,64569,51827,12742,24.6,2008/11/14(19:00)
2008,11,13,70532,64369,52308,12061,23.1,2008/11/13(19:00)
2008,11,12,70532,64560,51936,12624,24.3,2008/11/12(19:00)
2008,11,11,70532,64541,52333,12208,23.3,2008/11/11(19:00)
2008,11,10,70532,64701,52275,12426,23.8,2008/11/10(19:00)
2008,11,09,70532,63000,44857,18143,40.4,2008/11/09(23:00)
2008,11,08,70532,63140,45681,17459,38.2,2008/11/08(23:00)
2008,11,07,70532,64011,51675,12336,23.9,2008/11/07(19:00)
2008,11,06,70532,64035,52041,11994,23,2008/11/06(19:00)
2008,11,05,70532,64049,51727,12322,23.8,2008/11/05(19:00)
2008,11,04,70532,64550,52398,12152,23.2,2008/11/04(19:00)
2008,11,03,70532,64591,51982,12609,24.3,2008/11/03(19:00)
2008,11,02,70532,64329,44411,19918,44.8,2008/11/02(23:00)
2008,11,01,70532,63980,45830,18150,39.6,2008/11/01(23:00)
2008,10,31,70532,65456,51380,14076,27.4,2008/10/31(19:00)
2008,10,30,70532,65001,52125,12876,24.7,2008/10/30(19:00)
2008,10,29,70532,64030,51713,12317,23.8,2008/10/29(19:00)
2008,10,28,70532,63745,52212,11533,22.1,2008/10/28(19:00)
2008,10,27,70532,62599,51928,10671,20.5,2008/10/27(19:00)
2008,10,26,70532,59974,43745,16229,37.1,2008/10/26(23:00)
2008,10,25,70532,60953,45533,15420,33.9,2008/10/25(22:00)
2008,10,24,70532,61929,51403,10526,20.5,2008/10/24(19:00)
2008,10,23,70532,61651,53232,8419,15.8,2008/10/23(19:00)
2008,10,21,70532,62360,52943,9417,17.8,2008/10/21(19:00)
2008,10,20,70532,62360,52689,9671,18.4,2008/10/20(19:00)
2008,10,19,70532,61215,43324,17891,41.3,2008/10/19(20:00)
2008,10,18,70532,61985,46470,15515,33.4,2008/10/18(20:00)
2008,10,17,70532,63969,52452,11517,22,2008/10/17(19:00)
2008,10,16,70532,64260,53132,11128,20.9,2008/10/16(19:00)
2008,10,15,70532,64464,52185,12279,23.5,2008/10/15(19:00)
2008,10,14,70532,63476,52584,10892,20.7,2008/10/14(19:00)
2008,10,13,70532,62873,52237,10636,20.4,2008/10/13(19:00)
2008,10,12,70532,60019,43606,16413,37.6,2008/10/12(20:00)
2008,10,11,70532,60412,45675,14737,32.3,2008/10/11(20:00)
2008,10,10,70532,61396,52481,8915,17,2008/10/10(19:00)
2008,10,09,70532,61368,53188,8180,15.4,2008/10/09(19:00)
2008,10,08,70532,61754,52454,9300,17.7,2008/10/08(19:00)
2008,10,07,70532,61885,52885,9000,17,2008/10/07(19:00)
2008,10,06,70532,61178,52714,8464,16.1,2008/10/06(19:00)
2008,10,05,70532,59989,43884,16105,36.7,2008/10/05(20:00)
2008,10,04,70532,59937,45894,14043,30.6,2008/10/04(20:00)
2008,10,03,70532,59990,47912,12078,25.2,2008/10/03(20:00)
2008,10,02,70532,60759,52025,8734,16.8,2008/10/02(20:00)
2008,10,01,70532,60619,51896,8723,16.8,2008/10/01(20:00)
2008,09,30,70353,60968,51544,9424,18.3,2008/09/30(20:00)
2008,09,29,70353,60674,51196,9478,18.5,2008/09/29(20:00)
2008,09,28,70353,60498,43200,17298,40,2008/09/28(20:00)
2008,09,27,70353,59998,45245,14753,32.6,2008/09/27(12:00)
2008,09,26,70353,62373,50569,11804,23.3,2008/09/26(20:00)
2008,09,25,70353,62196,52810,9386,17.8,2008/09/25(20:00)
2008,09,24,70353,62579,54257,8322,15.3,2008/09/24(15:00)
2008,09,23,70353,62579,55246,7333,13.3,2008/09/23(15:00)
2008,09,22,70353,62601,55430,7171,12.9,2008/09/22(15:00)
2008,09,21,70353,60969,46749,14220,30.4,2008/09/21(20:00)
2008,09,20,70353,61592,50966,10626,20.8,2008/09/20(12:00)
2008,09,18,70353,63772,58510,5262,9,2008/09/18(15:00)
2008,09,17,70353,63025,55875,7150,12.8,2008/09/17(15:00)
2008,09,16,70353,63881,48715,15166,31.1,2008/09/16(20:00)
2008,09,15,70353,65285,40474,24811,61.3,2008/09/15(20:00)
2008,09,14,70353,65285,36649,28636,78.1,2008/09/14(21:00)
2008,09,13,70353,65285,40415,24870,61.5,2008/09/13(20:00)
2008,09,12,70353,66831,53880,12951,24,2008/09/12(12:00)
2008,09,11,70353,66798,56543,10255,18.1,2008/09/11(15:00)
2008,09,10,70353,66651,57585,9066,15.7,2008/09/10(15:00)
2008,09,09,70353,66651,58222,8429,14.5,2008/09/09(15:00)
2008,09,08,70353,66255,58219,8036,13.8,2008/09/08(15:00)
2008,09,07,70353,64329,47856,16473,34.4,2008/09/07(20:00)
2008,09,06,70353,65058,50723,14335,28.3,2008/09/06(15:00)
2008,09,05,70353,67087,55678,11409,20.5,2008/09/05(15:00)
2008,09,04,70353,68237,55735,12502,22.4,2008/09/04(15:00)
2008,09,03,70353,69242,56596,12646,22.3,2008/09/03(15:00)
2008,09,02,70353,69259,54917,14342,26.1,2008/09/02(15:00)
2008,09,01,70353,69487,55319,14168,25.6,2008/09/01(15:00)
2008,08,31,70353,69830,46536,23294,50.1,2008/08/31(21:00)
2008,08,30,70353,70185,50791,19394,38.2,2008/08/30(15:00)
2008,08,29,70353,71055,57413,13642,23.8,2008/08/29(15:00)
2008,08,28,70353,71055,56509,14546,25.7,2008/08/28(17:00)
2008,08,27,70353,71609,55526,16083,29,2008/08/27(15:00)
2008,08,26,70353,71989,55634,16355,29.4,2008/08/26(15:00)
2008,08,25,70353,71946,55985,15961,28.5,2008/08/25(15:00)
2008,08,24,70353,71027,45618,25409,55.7,2008/08/24(21:00)
2008,08,23,70353,71682,48272,23410,48.5,2008/08/23(15:00)
2008,08,22,70353,72081,52535,19546,37.2,2008/08/22(12:00)
2008,08,21,70353,72081,54501,17580,32.3,2008/08/21(12:00)
2008,08,20,70353,71669,55810,15859,28.4,2008/08/20(12:00)
2008,08,19,70353,72090,55990,16100,28.8,2008/08/19(12:00)
2008,08,18,70353,71618,56804,14814,26.1,2008/08/18(12:00)
2008,08,17,70353,70632,45791,24841,54.2,2008/08/17(21:00)
2008,08,16,70353,70443,47768,22675,47.5,2008/08/16(12:00)
2008,08,15,70353,70799,53341,17458,32.7,2008/08/15(12:00)
2008,08,14,70353,71896,61297,10599,17.3,2008/08/14(12:00)
2008,08,13,70353,71663,61271,10392,17,2008/08/13(15:00)
2008,08,12,70353,71055,61263,9792,16,2008/08/12(12:00)
2008,08,11,70353,71155,62511,8644,13.8,2008/08/11(15:00)
2008,08,10,70353,69644,52291,17353,33.2,2008/08/10(21:00)
2008,08,09,70353,70310,55237,15073,27.3,2008/08/09(12:00)
2008,08,08,70353,70799,60439,10360,17.1,2008/08/08(17:00)
2008,08,07,70353,71407,58978,12429,21.1,2008/08/07(17:00)
2008,08,06,70353,71407,58157,13250,22.8,2008/08/06(15:00)
2008,08,05,70353,70927,57858,13069,22.6,2008/08/05(15:00)
2008,08,04,70353,71393,55879,15514,27.8,2008/08/04(15:00)
2008,08,03,70353,70569,46960,23609,50.3,2008/08/03(21:00)
2008,08,02,70353,70819,47745,23074,48.3,2008/08/02(15:00)
2008,08,01,70353,70910,53939,16971,31.5,2008/08/01(15:00)
2008,07,31,70353,71026,55427,15599,28.1,2008/07/31(15:00)
2008,07,30,70353,70789,56464,14325,25.4,2008/07/30(15:00)
2008,07,29,70353,69707,59775,9932,16.6,2008/07/29(15:00)
2008,07,28,70353,69995,58289,11706,20.1,2008/07/28(15:00)
2008,07,27,70353,67247,47876,19371,40.5,2008/07/27(21:00)
2008,07,26,70353,67498,49984,17514,35,2008/07/26(12:00)
2008,07,25,70353,68143,56714,11429,20.2,2008/07/25(12:00)
2008,07,24,70353,67655,58152,9503,16.3,2008/07/24(12:00)
2008,07,23,70353,67705,58277,9428,16.2,2008/07/23(12:00)
2008,07,22,70353,68250,57800,10450,18.1,2008/07/22(17:00)
2008,07,21,70353,69313,57878,11435,19.8,2008/07/21(15:00)
2008,07,20,70353,67482,48457,19025,39.3,2008/07/20(21:00)
2008,07,19,70353,67987,53759,14228,26.5,2008/07/19(12:00)
2008,07,18,70353,68514,61548,6966,11.3,2008/07/18(15:00)
2008,07,17,70353,68605,60563,8042,13.3,2008/07/17(15:00)
2008,07,16,70353,68519,60383,8136,13.5,2008/07/16(12:00)
2008,07,15,70353,68519,62794,5725,9.1,2008/07/15(15:00)
2008,07,14,70353,68379,62466,5913,9.5,2008/07/14(15:00)
2008,07,13,70353,66250,49076,17174,35,2008/07/13(21:00)
2008,07,12,70353,64413,52976,11437,21.6,2008/07/12(12:00)
2008,07,11,70353,68146,61017,7129,11.7,2008/07/11(15:00)
2008,07,10,70353,68146,61343,6803,11.1,2008/07/10(15:00)
2008,07,09,70353,68084,62478,5606,9,2008/07/09(15:00)
2008,07,08,70353,66999,62248,4751,7.6,2008/07/08(15:00)
2008,07,07,70353,67260,60234,7026,11.7,2008/07/07(15:00)
2008,07,06,70353,65764,48583,17181,35.4,2008/07/06(21:00)
2008,07,05,70353,65981,51356,14625,28.5,2008/07/05(12:00)
2008,07,04,70353,65629,57398,8231,14.3,2008/07/04(15:00)
2008,07,03,70353,64887,55081,9806,17.8,2008/07/03(15:00)
2008,07,02,70353,66228,54465,11763,21.6,2008/07/02(15:00)
2008,07,01,70353,66228,54770,11458,20.9,2008/07/01(15:00)
2008,06,30,70353,66014,53872,12142,22.5,2008/06/30(15:00)
2008,06,29,70353,65248,44366,20882,47.1,2008/06/29(21:00)
2008,06,28,70353,66222,49013,17209,35.1,2008/06/28(12:00)
2008,06,27,70353,67065,55504,11561,20.8,2008/06/27(15:00)
2008,06,26,70353,66680,54934,11746,21.4,2008/06/26(15:00)
2008,06,25,70353,66463,54365,12098,22.3,2008/06/25(15:00)
2008,06,24,70353,66113,53570,12543,23.4,2008/06/24(15:00)
2008,06,23,70353,65376,53081,12295,23.2,2008/06/23(15:00)
2008,06,22,70353,65310,44551,20759,46.6,2008/06/22(21:00)
2008,06,21,70353,64885,49383,15502,31.4,2008/06/21(12:00)
2008,06,20,70353,66154,54719,11435,20.9,2008/06/20(15:00)
2008,06,19,70353,64919,52780,12139,23,2008/06/19(17:00)
2008,06,18,70353,65069,52571,12498,23.8,2008/06/18(15:00)
2008,06,17,70353,65828,52241,13587,26,2008/06/17(17:00)
2008,06,16,69825,66350,52061,14289,27.4,2008/06/16(17:00)
2008,06,15,69825,64487,43806,20681,47.2,2008/06/15(21:00)
2008,06,14,69825,63414,48565,14849,30.6,2008/06/14(12:00)
2008,06,13,69825,64275,54109,10166,18.8,2008/06/13(15:00)
2008,06,12,69825,63683,54429,9254,17,2008/06/12(17:00)
2008,06,11,69825,62526,53566,8960,16.7,2008/06/11(14:00)
2008,06,10,69825,62299,53545,8754,16.3,2008/06/10(15:00)
2008,06,09,69825,63034,52099,10935,21,2008/06/09(17:00)
2008,06,08,69825,61159,42900,18259,42.6,2008/06/08(21:00)
2008,06,07,69825,61202,44884,16318,36.4,2008/06/07(21:00)
2008,06,06,69825,62436,46629,15807,33.9,2008/06/06(21:00)
2008,06,05,69825,64571,49944,14627,29.3,2008/06/05(12:00)
2008,06,04,69825,64571,50186,14385,28.7,2008/06/04(17:00)
2008,06,03,69825,64253,51159,13094,25.6,2008/06/03(15:00)
2008,06,02,69825,63718,50590,13128,25.9,2008/06/02(17:00)
2008,06,01,69825,62168,43590,18578,42.6,2008/06/01(21:00)
2008,05,31,68888,61568,46173,15395,33.3,2008/05/31(12:00)
2008,05,30,68888,62543,50815,11728,23.1,2008/05/30(15:00)
2008,05,29,68888,62386,52633,9753,18.5,2008/05/29(15:00)
2008,05,28,68888,62765,51264,11501,22.4,2008/05/28(15:00)
2008,05,27,68888,62784,52362,10422,19.9,2008/05/27(15:00)
2008,05,26,68888,63198,50839,12359,24.3,2008/05/26(17:00)
2008,05,25,68888,62163,43497,18666,42.9,2008/05/25(21:00)
2008,05,24,68888,62834,47098,15736,33.4,2008/05/24(12:00)
2008,05,23,68888,62901,51246,11655,22.7,2008/05/23(15:00)
2008,05,22,68888,62367,50636,11731,23.2,2008/05/22(21:00)
2008,05,21,68888,62342,49755,12587,25.3,2008/05/21(21:00)
2008,05,20,68888,61567,49854,11713,23.5,2008/05/20(21:00)
2008,05,19,68888,60791,49408,11383,23,2008/05/19(21:00)
2008,05,18,68888,60640,43986,16654,37.9,2008/05/18(23:00)
2008,05,17,68888,60978,46686,14292,30.6,2008/05/17(12:00)
2008,05,16,68888,62052,49825,12227,24.5,2008/05/16(21:00)
2008,05,15,68888,61959,50304,11655,23.2,2008/05/15(21:00)
2008,05,14,68888,60917,49830,11087,22.2,2008/05/14(21:00)
2008,05,13,68888,60910,50306,10604,21.1,2008/05/13(20:00)
2008,05,12,68888,61438,45738,15700,34.3,2008/05/12(23:00)
2008,05,11,68888,60122,43239,16883,39,2008/05/11(23:00)
2008,05,10,68888,60990,46252,14738,31.9,2008/05/10(12:00)
2008,05,09,68888,61547,49592,11955,24.1,2008/05/09(20:00)
2008,05,08,68888,61228,49958,11270,22.6,2008/05/08(15:00)
2008,05,07,68888,61496,49733,11763,23.7,2008/05/07(20:00)
2008,05,06,68888,61510,49947,11563,23.2,2008/05/06(21:00)
2008,05,05,68888,61426,44025,17401,39.5,2008/05/05(23:00)
2008,05,04,68888,59718,42349,17369,41,2008/05/04(23:00)
2008,05,03,68888,61069,45088,15981,35.4,2008/05/03(15:00)
2008,05,02,68888,61793,48810,12983,26.6,2008/05/02(20:00)
2008,05,01,68888,61793,45929,15864,34.5,2008/05/01(21:00)
2008,04,30,68888,61800,49554,12246,24.7,2008/04/30(15:00)
2008,04,29,68888,61534,50352,11182,22.2,2008/04/29(20:00)
2008,04,28,68888,61652,50053,11599,23.2,2008/04/28(20:00)
2008,04,27,68888,61065,45436,15629,34.4,2008/04/27(23:00)
2008,04,26,68888,62272,47023,15249,32.4,2008/04/26(24:00)
2008,04,25,68888,62466,50045,12421,24.8,2008/04/25(20:00)
2008,04,24,68888,62822,50448,12374,24.5,2008/04/24(20:00)
2008,04,23,68888,62516,50075,12441,24.8,2008/04/23(11:00)
2008,04,22,68888,61855,50544,11311,22.4,2008/04/22(20:00)
2008,04,21,68888,61855,50125,11730,23.4,2008/04/21(20:00)
2008,04,20,68888,63027,43643,19384,44.4,2008/04/20(23:00)
2008,04,19,68888,61430,45571,15859,34.8,2008/04/19(12:00)
2008,04,18,68888,61570,49927,11643,23.3,2008/04/18(20:00)
2008,04,17,68888,61975,50420,11555,22.9,2008/04/17(20:00)
2008,04,16,68888,61755,49796,11959,24,2008/04/16(20:00)
2008,04,15,68888,61751,50308,11443,22.7,2008/04/15(20:00)
2008,04,14,68888,61952,50560,11392,22.5,2008/04/14(20:00)
2008,04,13,68888,61665,45118,16547,36.7,2008/04/13(23:00)
2008,04,12,68888,60953,46686,14267,30.6,2008/04/12(23:00)
2008,04,11,68888,62240,50197,12043,24,2008/04/11(20:00)
2008,04,10,68888,62174,50647,11527,22.8,2008/04/10(20:00)
2008,04,09,68888,62012,49498,12514,25.3,2008/04/09(23:00)
2008,04,08,68888,62545,50088,12457,24.9,2008/04/08(20:00)
2008,04,07,68888,61881,50947,10934,21.5,2008/04/07(20:00)
2008,04,06,68888,61376,44811,16565,37,2008/04/06(23:00)
2008,04,05,68888,61917,46960,14957,31.9,2008/04/05(23:00)
2008,04,04,68888,63504,51128,12376,24.2,2008/04/04(20:00)
2008,04,03,68888,64086,51957,12129,23.3,2008/04/03(20:00)
2008,04,02,68888,63953,52796,11157,21.1,2008/04/02(11:00)
2008,04,01,68888,64354,52288,12066,23.1,2008/04/01(20:00)
2008,03,31,68818,64412,52885,11527,21.8,2008/03/31(20:00)
2008,03,30,68818,63088,47102,15986,33.9,2008/03/30(23:00)
2008,03,29,68818,63088,49355,13733,27.8,2008/03/29(24:00)
2008,03,28,68818,64436,52319,12117,23.2,2008/03/28(20:00)
2008,03,27,68818,64447,53503,10944,20.5,2008/03/27(20:00)
2008,03,26,68818,63615,52591,11024,21,2008/03/26(20:00)
2008,03,25,68818,62762,53713,9049,16.8,2008/03/25(20:00)
2008,03,24,68818,62640,52477,10163,19.4,2008/03/24(20:00)
2008,03,23,68818,63544,46790,16754,35.8,2008/03/23(23:00)
2008,03,22,68818,62563,47792,14771,30.9,2008/03/22(23:00)
2008,03,21,68818,64319,51247,13072,25.5,2008/03/21(20:00)
2008,03,20,68818,63840,52082,11758,22.6,2008/03/20(20:00)
2008,03,19,68818,63448,51986,11462,22,2008/03/19(20:00)
2008,03,18,68818,63717,52375,11342,21.7,2008/03/18(20:00)
2008,03,17,68818,63619,52728,10891,20.7,2008/03/17(20:00)
2008,03,16,68818,63699,46921,16778,35.8,2008/03/16(23:00)
2008,03,15,68818,62935,48826,14109,28.9,2008/03/15(01:00)
2008,03,14,68818,64021,52608,11413,21.7,2008/03/14(20:00)
2008,03,13,68818,63410,53367,10043,18.8,2008/03/13(20:00)
2008,03,12,68818,64280,52902,11378,21.5,2008/03/12(10:00)
2008,03,11,68818,64657,53493,11164,20.9,2008/03/11(10:00)
2008,03,10,68818,64666,54304,10362,19.1,2008/03/10(11:00)
2008,03,09,68818,64654,48347,16307,33.7,2008/03/09(23:00)
2008,03,08,68818,64490,51355,13135,25.6,2008/03/08(01:00)
2008,03,07,68818,65726,55272,10454,18.9,2008/03/07(11:00)
2008,03,06,68818,66253,56686,9567,16.9,2008/03/06(11:00)
2008,03,05,68818,66001,56405,9596,17,2008/03/05(11:00)
2008,03,04,68818,65771,56791,8980,15.8,2008/03/04(11:00)
2008,03,03,68818,65293,55959,9334,16.7,2008/03/03(11:00)
2008,03,02,68818,65598,49323,16275,33,2008/03/02(24:00)
2008,03,01,68818,64676,51472,13204,25.7,2008/03/01(01:00)
2008,02,29,68275,66294,56460,9834,17.4,2008/02/29(11:00)
2008,02,28,68275,66118,57146,8972,15.7,2008/02/28(11:00)
2008,02,27,68275,65811,58316,7495,12.9,2008/02/27(11:00)
2008,02,26,68275,66092,58583,7509,12.8,2008/02/26(12:00)
2008,02,25,68275,66084,58710,7374,12.6,2008/02/25(12:00)
2008,02,24,68275,66657,51214,15443,30.2,2008/02/24(24:00)
2008,02,23,68275,66389,53860,12529,23.3,2008/02/23(24:00)
2008,02,22,68275,67190,56256,10934,19.4,2008/02/22(11:00)
2008,02,21,68275,67190,57611,9579,16.6,2008/02/21(11:00)
2008,02,20,68275,67684,57809,9875,17.1,2008/02/20(11:00)
2008,02,19,68275,67945,59172,8773,14.8,2008/02/19(11:00)
2008,02,18,68275,67501,59464,8037,13.5,2008/02/18(11:00)
2008,02,17,68275,67460,52431,15029,28.7,2008/02/17(01:00)
2008,02,16,68275,68794,55263,13531,24.5,2008/02/16(01:00)
2008,02,15,68275,67701,59398,8303,14,2008/02/15(11:00)
2008,02,14,68275,67153,59689,7464,12.5,2008/02/14(11:00)
2008,02,13,68275,66308,60742,5566,9.2,2008/02/13(11:00)
2008,02,12,68275,65727,60610,5117,8.4,2008/02/12(11:00)
2008,02,11,68275,64893,58683,6210,10.6,2008/02/11(12:00)
2008,02,10,68275,64803,50693,14110,27.8,2008/02/10(24:00)
2008,02,09,68275,64803,49381,15422,31.2,2008/02/09(23:00)
2008,02,08,68275,65140,46181,18959,41.1,2008/02/08(24:00)
2008,02,07,68275,65140,44834,20306,45.3,2008/02/07(01:00)
2008,02,06,68275,65234,50720,14514,28.6,2008/02/06(01:00)
2008,02,05,68275,64868,57215,7653,13.4,2008/02/05(11:00)
2008,02,04,68275,64432,58788,5644,9.6,2008/02/04(11:00)
2008,02,03,68275,65342,53137,12205,23,2008/02/03(24:00)
2008,02,02,68275,64942,55263,9679,17.5,2008/02/02(24:00)
2008,02,01,68275,65944,59181,6763,11.4,2008/02/01(11:00)
2008,01,31,68268,66668,59887,6781,11.3,2008/01/31(11:00)
2008,01,30,68268,66688,59425,7263,12.2,2008/01/30(12:00)
2008,01,29,68268,66688,59673,7015,11.8,2008/01/29(11:00)
2008,01,28,68268,66688,59758,6930,11.6,2008/01/28(12:00)
2008,01,27,68268,65789,52242,13547,25.9,2008/01/27(01:00)
2008,01,26,68268,65489,55430,10059,18.1,2008/01/26(01:00)
2008,01,25,68268,66548,60502,6046,10,2008/01/25(11:00)
2008,01,24,68268,66664,60256,6408,10.6,2008/01/24(11:00)
2008,01,23,68268,66190,58738,7452,12.7,2008/01/23(19:00)
2008,01,22,68268,66176,59449,6727,11.3,2008/01/22(12:00)
2008,01,21,68268,65308,59762,5546,9.3,2008/01/21(12:00)
2008,01,20,68268,64870,52086,12784,24.5,2008/01/20(01:00)
2008,01,19,68268,65391,55656,9735,17.5,2008/01/19(01:00)
2008,01,18,68268,66204,60497,5707,9.4,2008/01/18(11:00)
2008,01,17,68268,65682,60947,4735,7.8,2008/01/17(12:00)
2008,01,16,68268,65626,59938,5688,9.5,2008/01/16(11:00)
2008,01,15,68268,66176,59445,6731,11.3,2008/01/15(19:00)
2008,01,14,68268,65926,58961,6965,11.8,2008/01/14(19:00)
2008,01,13,68268,66283,51660,14623,28.3,2008/01/13(24:00)
2008,01,12,68268,66283,53238,13045,24.5,2008/01/12(24:00)
2008,01,11,68268,65978,58615,7363,12.6,2008/01/11(12:00)
2008,01,10,68268,66374,57368,9006,15.7,2008/01/10(11:00)
2008,01,09,68268,66131,57507,8624,15,2008/01/09(11:00)
2008,01,08,68268,65926,57520,8406,14.6,2008/01/08(11:00)
2008,01,07,68268,65478,57725,7753,13.4,2008/01/07(12:00)
2008,01,06,68268,65213,50859,14354,28.2,2008/01/06(01:00)
2008,01,05,68268,66011,53553,12458,23.3,2008/01/05(01:00)
2008,01,03,68268,65811,58416,7395,12.7,2008/01/03(11:00)
2008,01,02,68268,65551,57226,8325,14.5,2008/01/02(19:00)
2008,01,01,68268,64958,50746,14212,28,2008/01/01(01:00)
2007,12,31,68268,66544,52130,14414,27.7,2007/12/31(23:00)
2007,12,30,68251,66544,51955,14589,28.1,2007/12/30(23:00)
2007,12,29,68251,65959,52227,13732,26.3,2007/12/29(23:00)
2007,12,28,68251,65434,55008,10426,19,2007/12/28(11:00)
2007,12,27,68251,65510,55390,10120,18.3,2007/12/27(11:00)
2007,12,26,68251,65631,55063,10568,19.2,2007/12/26(11:00)
2007,12,25,68251,65841,51564,14277,27.7,2007/12/25(23:00)
2007,12,24,68251,66106,55712,10394,18.7,2007/12/24(11:00)
2007,12,23,68251,65321,50655,14666,29,2007/12/23(23:00)
2007,12,22,68251,65627,52512,13115,25,2007/12/22(01:00)
2007,12,21,68251,66380,57435,8945,15.6,2007/12/21(18:00)
2007,12,20,68251,65827,57655,8172,14.2,2007/12/20(19:00)
2007,12,19,68251,65756,54261,11495,21.2,2007/12/19(23:00)
2007,12,18,68251,65999,58004,7995,13.8,2007/12/18(18:00)
2007,12,17,68251,65999,58122,7877,13.6,2007/12/17(19:00)
2007,12,16,68251,65189,51085,14104,27.6,2007/12/16(23:00)
2007,12,15,68251,65464,53078,12386,23.3,2007/12/15(23:00)
2007,12,14,68251,65754,57331,8423,14.7,2007/12/14(19:00)
2007,12,13,68251,65169,58007,7162,12.3,2007/12/13(19:00)
2007,12,12,68251,65049,56912,8137,14.3,2007/12/12(18:00)
2007,12,11,68251,65049,56820,8229,14.5,2007/12/11(19:00)
2007,12,10,68251,64355,57998,6357,11,2007/12/10(18:00)
2007,12,09,68251,63844,50577,13267,26.2,2007/12/09(23:00)
2007,12,08,68251,63478,53024,10454,19.7,2007/12/08(00:00)
2007,12,07,68251,64371,57111,7260,12.7,2007/12/07(18:00)
2007,12,06,68251,64313,58111,6202,10.7,2007/12/06(18:00)
2007,12,05,68251,64312,57850,6462,11.2,2007/12/05(18:00)
2007,12,04,68251,63552,58472,5080,8.7,2007/12/04(19:00)
2007,12,03,68251,64130,57308,6822,11.9,2007/12/03(19:00)
2007,12,02,68251,62102,49294,12808,26,2007/12/02(23:00)
2007,12,01,68251,63031,51225,11806,23,2007/12/01(01:00)
2007,11,30,67196,62794,55687,7107,12.8,2007/11/30(19:00)
2007,11,29,67196,62820,55383,7437,13.4,2007/11/29(19:00)
2007,11,28,67196,62608,55304,7304,13.2,2007/11/28(11:00)
2007,11,27,67196,62536,56595,5941,10.5,2007/11/27(19:00)
2007,11,26,67196,62465,55642,6823,12.3,2007/11/26(19:00)
2007,11,25,67196,62675,48314,14361,29.7,2007/11/25(23:00)
2007,11,24,67196,61440,50556,10884,21.5,2007/11/24(23:00)
2007,11,23,67196,62506,55282,7224,13.1,2007/11/23(18:00)
2007,11,22,67196,62267,56751,5516,9.7,2007/11/22(19:00)
2007,11,21,67196,63838,56200,7638,13.6,2007/11/21(19:00)
2007,11,20,67196,63707,57121,6586,11.5,2007/11/20(19:00)
2007,11,19,67196,64146,57109,7037,12.3,2007/11/19(19:00)
2007,11,18,67196,62880,49039,13841,28.2,2007/11/18(00:00)
2007,11,17,67196,62880,49761,13119,26.4,2007/11/17(23:00)
2007,11,16,67196,62479,53659,8820,16.4,2007/11/16(19:00)
2007,11,15,67196,63072,53330,9742,18.3,2007/11/15(19:00)
2007,11,14,67196,62842,52620,10222,19.4,2007/11/14(19:00)
2007,11,13,67196,63499,53429,10070,18.8,2007/11/13(19:00)
2007,11,12,67196,63489,52675,10814,20.5,2007/11/12(19:00)
2007,11,11,67196,62364,45593,16771,36.8,2007/11/11(23:00)
2007,11,10,67196,63207,47364,15843,33.4,2007/11/10(00:00)
2007,11,09,67196,63948,52023,11925,22.9,2007/11/09(19:00)
2007,11,08,67196,62524,52619,9905,18.8,2007/11/08(19:00)
2007,11,07,67196,63172,51526,11646,22.6,2007/11/07(19:00)
2007,11,06,67196,62503,52394,10109,19.3,2007/11/06(19:00)
2007,11,05,67196,63402,52597,10805,20.5,2007/11/05(19:00)
2007,11,04,67196,62153,45334,16819,37.1,2007/11/04(23:00)
2007,11,03,67196,61293,46908,14385,30.7,2007/11/03(23:00)
2007,11,02,67196,60810,51060,9750,19.1,2007/11/02(19:00)
2007,11,01,67196,61721,51877,9844,19,2007/11/01(19:00)
2007,10,31,67196,60987,51051,9936,19.5,2007/10/31(19:00)
2007,10,30,67196,59905,51878,8027,15.5,2007/10/30(19:00)
2007,10,29,67196,59733,51868,7865,15.2,2007/10/29(19:00)
2007,10,28,67196,61044,43781,17263,39.4,2007/10/28(23:00)
2007,10,27,67196,60426,45476,14950,32.9,2007/10/27(23:00)
2007,10,26,67196,60037,50600,9437,18.7,2007/10/26(19:00)
2007,10,25,67196,60744,51527,9217,17.9,2007/10/25(19:00)
2007,10,24,67196,60255,50696,9559,18.9,2007/10/24(19:00)
2007,10,23,67196,60500,51294,9206,17.9,2007/10/23(19:00)
2007,10,22,67196,60500,50931,9569,18.8,2007/10/22(19:00)
2007,10,21,67196,60922,44221,16701,37.8,2007/10/21(23:00)
2007,10,20,67196,59474,46161,13313,28.8,2007/10/20(23:00)
2007,10,19,67196,59641,49968,9673,19.4,2007/10/19(19:00)
2007,10,18,67196,59366,50465,8901,17.6,2007/10/18(19:00)
2007,10,17,67196,59401,49931,9470,19,2007/10/17(19:00)
2007,10,16,67196,59759,50304,9455,18.8,2007/10/16(19:00)
2007,10,15,67196,59892,49677,10215,20.6,2007/10/15(19:00)
2007,10,14,67196,59203,42218,16985,40.2,2007/10/14(23:00)
2007,10,13,67196,58889,43556,15333,35.2,2007/10/13(11:00)
2007,10,12,67196,59806,49564,10242,20.7,2007/10/12(19:00)
2007,10,11,67196,59806,50044,9762,19.5,2007/10/11(19:00)
2007,10,10,67196,60030,49685,10345,20.8,2007/10/10(20:00)
2007,10,09,67196,59640,50030,9610,19.2,2007/10/09(20:00)
2007,10,08,67196,57582,49993,7589,15.2,2007/10/08(19:00)
2007,10,07,67196,58147,43032,15115,35.1,2007/10/07(20:00)
2007,10,06,67196,57675,45538,12137,26.7,2007/10/06(12:00)
2007,10,05,67196,59376,50563,8813,17.4,2007/10/05(20:00)
2007,10,04,67196,59380,51328,8052,15.7,2007/10/04(20:00)
2007,10,03,67196,58355,47283,11072,23.4,2007/10/03(20:00)
2007,10,02,67196,58685,50772,7913,15.6,2007/10/02(19:00)
2007,10,01,67196,58824,50325,8499,16.9,2007/10/01(20:00)
2007,09,30,67196,58775,42970,15805,36.8,2007/09/30(20:00)
2007,09,29,67196,59035,45188,13847,30.6,2007/09/29(12:00)
2007,09,28,67196,59794,48630,11164,23,2007/09/28(20:00)
2007,09,27,67196,59894,47539,12355,26,2007/09/27(20:00)
2007,09,26,67191,61695,37671,24024,63.8,2007/09/26(20:00)
2007,09,25,67196,60509,34024,26485,77.8,2007/09/25(23:00)
2007,09,24,67196,60552,36266,24286,67,2007/09/24(20:00)
2007,09,23,67196,60552,41191,19361,47,2007/09/23(20:00)
2007,09,22,67196,60470,45931,14539,31.7,2007/09/22(11:00)
2007,09,21,67196,61562,54409,7153,13.1,2007/09/21(15:00)
2007,09,20,67196,61505,57220,4285,7.5,2007/09/20(15:00)
2007,09,19,67196,61281,55475,5806,10.5,2007/09/19(15:00)
2007,09,18,67196,61612,52524,9088,17.3,2007/09/18(20:00)
2007,09,17,67196,61140,53153,7987,15,2007/09/17(20:00)
2007,09,16,67196,60116,43409,16707,38.5,2007/09/16(20:00)
2007,09,15,67196,61318,48419,12899,26.6,2007/09/15(12:00)
2007,09,14,67196,61775,52905,8870,16.8,2007/09/14(15:00)
2007,09,13,67196,62801,54424,8377,15.4,2007/09/13(15:00)
2007,09,12,67196,62264,54931,7333,13.3,2007/09/12(15:00)
2007,09,11,67196,61695,54045,7650,14.2,2007/09/11(15:00)
2007,09,10,67196,62677,53671,9006,16.8,2007/09/10(15:00)
2007,09,09,67196,61766,43371,18395,42.4,2007/09/09(20:00)
2007,09,08,67196,61586,47020,14566,31,2007/09/08(12:00)
2007,09,07,67196,63149,51134,12015,23.5,2007/09/07(20:00)
2007,09,06,67196,64144,50204,13940,27.8,2007/09/06(20:00)
2007,09,05,67196,64768,51041,13727,26.9,2007/09/05(15:00)
2007,09,04,67196,64768,51847,12921,24.9,2007/09/04(20:00)
2007,09,03,67196,64369,52027,12342,23.7,2007/09/03(15:00)
2007,09,02,67196,62759,42545,20214,47.5,2007/09/02(21:00)
2007,09,01,67196,63604,46815,16789,35.9,2007/09/01(12:00)
2007,08,31,67196,66718,52790,13928,26.4,2007/08/31(15:00)
2007,08,30,67196,66718,52947,13771,26,2007/08/30(15:00)
2007,08,29,67196,66718,55558,11160,20.1,2007/08/29(12:00)
2007,08,28,67196,67027,60092,6935,11.5,2007/08/28(15:00)
2007,08,27,67196,66785,61604,5181,8.4,2007/08/27(15:00)
2007,08,26,67196,66046,50541,15505,30.7,2007/08/26(21:00)
2007,08,25,67196,65238,56418,8820,15.6,2007/08/25(15:00)
2007,08,24,67196,66613,61511,5102,8.3,2007/08/24(15:00)
2007,08,23,97196,66613,60529,6084,10.1,2007/08/23(15:00)
2007,08,22,67196,66743,61661,5082,8.2,2007/08/22(15:00)
2007,08,21,67196,66778,62285,4493,7.2,2007/08/21(15:00)
2007,08,20,67196,66006,61545,4461,7.2,2007/08/20(15:00)
2007,08,19,67196,66852,49080,17772,36.2,2007/08/19(21:00)
2007,08,18,67196,66975,54787,12188,22.2,2007/08/18(12:00)
2007,08,17,67196,66975,60603,6372,10.5,2007/08/17(15:00)
2007,08,16,67196,66704,59925,6779,11.3,2007/08/16(15:00)
2007,08,15,67196,66704,52530,14174,27,2007/08/15(21:00)
2007,08,14,67196,66704,57455,9249,16.1,2007/08/14(12:00)
2007,08,13,67196,66704,57454,9250,16.1,2007/08/13(12:00)
2007,08,12,67196,65825,46532,19293,41.5,2007/08/12(21:00)
2007,08,11,67196,64718,52383,12335,23.5,2007/08/11(15:00)
2007,08,10,67196,65756,57432,8324,14.5,2007/08/10(12:00)
2007,08,09,67196,65696,56308,9388,16.7,2007/08/09(12:00)
2007,08,08,67196,66251,52869,13382,25.3,2007/08/08(17:00)
2007,08,07,67196,66929,51701,15228,29.5,2007/08/07(12:00)
2007,08,06,67196,66929,51374,15555,30.3,2007/08/06(17:00)
2007,08,05,66673,66458,44620,21838,48.9,2007/08/05(21:00)
2007,08,04,66673,66398,45846,20552,44.8,2007/08/04(21:00)
2007,08,03,66673,66895,52597,14298,27.2,2007/08/03(14:00)
2007,08,02,66673,66586,52180,14406,27.6,2007/08/02(15:00)
2007,08,01,66673,65741,52123,13618,26.1,2007/08/01(15:00)
2007,07,31,66673,64594,53112,11482,21.6,2007/07/31(15:00)
2007,07,30,66673,64854,53122,11732,22.1,2007/07/30(15:00)
2007,07,29,66673,63538,45338,18200,40.1,2007/07/29(21:00)
2007,07,28,66673,63167,51138,12029,23.5,2007/07/28(12:00)
2007,07,27,66673,65321,57913,7408,12.8,2007/07/27(15:00)
2007,07,26,66673,64731,56929,7802,13.7,2007/07/26(15:00)
2007,07,25,66673,64731,54925,9806,17.9,2007/07/25(15:00)
2007,07,24,66673,64731,53655,11076,20.6,2007/07/24(17:00)
2007,07,23,66673,64731,53359,11372,21.3,2007/07/23(15:00)
2007,07,22,66673,63958,44004,19954,45.3,2007/07/22(21:00)
2007,07,21,66673,63342,47133,16209,34.4,2007/07/21(12:00)
2007,07,20,66673,63769,54439,9330,17.1,2007/07/20(12:00)
2007,07,19,66673,62919,53691,9228,17.2,2007/07/19(12:00)
2007,07,18,66673,63493,55774,7719,13.8,2007/07/18(15:00)
2007,07,17,66673,64250,47556,16694,35.1,2007/07/17(21:00)
2007,07,16,66673,63999,50296,13703,27.2,2007/07/16(15:00)
2007,07,15,66673,64087,44106,19981,45.3,2007/07/15(21:00)
2007,07,14,66673,63808,46809,16999,36.3,2007/07/14(15:00)
2007,07,13,66673,63765,54314,9451,17.4,2007/07/13(15:00)
2007,07,12,66673,63732,54189,9543,17.6,2007/07/12(15:00)
2007,07,11,66673,63765,51130,12635,24.7,2007/07/11(15:00)
2007,07,10,66673,63765,51588,12177,23.6,2007/07/10(15:00)
2007,07,09,66673,63765,53833,9932,18.4,2007/07/09(15:00)
2007,07,08,66673,62975,45148,17827,39.5,2007/07/08(21:00)
2007,07,07,66673,63245,49036,14209,29,2007/07/07(15:00)
2007,07,06,66673,63765,54093,9672,17.9,2007/07/06(15:00)
2007,07,05,66673,62724,53249,9475,17.8,2007/07/05(15:00)
2007,07,04,66673,62692,51555,11137,21.6,2007/07/04(15:00)
2007,07,03,66673,63724,53385,10339,19.4,2007/07/03(15:00)
2007,07,02,66673,63833,51075,12758,25,2007/07/02(15:00)
2007,07,01,66673,62365,42444,19921,46.9,2007/07/01(21:00)
2007,06,30,66673,60254,48170,12084,25.1,2007/06/30(17:00)
2007,06,29,66673,61812,53249,8563,16.1,2007/06/29(15:00)
2007,06,28,66673,61962,55659,6303,11.3,2007/06/28(15:00)
2007,06,27,66673,61442,55800,5642,10.1,2007/06/27(15:00)
2007,06,26,66673,60875,54551,6324,11.6,2007/06/26(15:00)
2007,06,25,66673,60814,51570,9244,17.9,2007/06/25(17:00)
2007,06,24,66673,60204,43047,17157,39.9,2007/06/24(21:00)
2007,06,23,66673,58034,48084,9950,20.7,2007/06/23(12:00)
2007,06,22,66673,59334,53477,5857,11,2007/06/22(17:00)
2007,06,21,66673,61609,52620,8989,17.1,2007/06/21(15:00)
2007,06,20,66673,61450,55016,6434,11.7,2007/06/20(15:00)
2007,06,19,66673,61171,54527,6644,12.2,2007/06/19(15:00)
2007,06,18,66673,60902,53508,7394,13.8,2007/06/18(15:00)
2007,06,17,66673,59836,42762,17074,39.9,2007/06/17(21:00)
2007,06,16,66673,58011,46484,11527,24.8,2007/06/16(12:00)
2007,06,15,66673,59723,50677,9046,17.9,2007/06/15(15:00)
2007,06,14,66673,61347,51176,10171,19.9,2007/06/14(15:00)
2007,06,13,66673,61492,51707,9785,18.9,2007/06/13(15:00)
2007,06,12,66673,61998,52459,9539,18.2,2007/06/12(15:00)
2007,06,11,66673,61610,51890,9720,18.7,2007/06/11(15:00)
2007,06,10,66673,59005,42197,16808,39.8,2007/06/10(21:00)
2007,06,09,66673,58865,44573,14292,32.1,2007/06/09(12:00)
2007,06,08,66673,60113,50084,10029,20,2007/06/08(15:00)
2007,06,07,66673,60677,50041,10636,21.3,2007/06/07(15:00)
2007,06,06,66673,60842,46001,14841,32.3,2007/06/06(21:00)
2007,06,05,66673,61049,49696,11353,22.8,2007/06/05(15:00)
2007,06,04,66673,60517,50104,10413,20.8,2007/06/04(15:00)
2007,06,03,66673,58935,41893,17042,40.7,2007/06/03(21:00)
2007,06,02,66673,58824,44827,13997,31.2,2007/06/02(12:00)
2007,06,01,66673,59405,47696,11709,24.5,2007/06/01(15:00)
2007,05,31,66167,58498,49166,9332,19,2007/05/31(15:00)
2007,05,30,66167,60495,47871,12624,26.4,2007/05/30(00:00)
2007,05,29,66167,60497,48714,11783,24.2,2007/05/29(06:00)
2007,05,28,66167,59460,48731,10729,22,2007/05/28(23:00)
2007,05,27,66167,57805,41604,16201,38.9,2007/05/27(23:00)
2007,05,26,66167,58396,43974,14422,32.8,2007/05/26(00:00)
2007,05,25,66167,58826,47395,11431,24.1,2007/05/25(06:00)
2007,05,24,66167,58507,45392,13115,28.9,2007/05/24(23:00)
2007,05,23,66167,58035,48294,9741,20.2,2007/05/23(23:00)
2007,05,22,66167,58383,48292,10091,20.9,2007/05/22(03:00)
2007,05,21,66167,58295,47770,10525,22,2007/05/21(07:00)
2007,05,20,66167,55298,41560,13738,33.1,2007/05/20(04:00)
2007,05,19,66167,55569,43957,11612,26.4,2007/05/19(23:00)
2007,05,18,66167,56442,47557,8885,18.7,2007/05/18(03:00)
2007,05,17,66167,56288,47865,8423,17.6,2007/05/17(03:00)
2007,05,16,66167,55950,48066,7884,16.4,2007/05/16(23:00)
2007,05,15,66167,55985,47992,7993,16.7,2007/05/15(06:00)
2007,05,14,66167,56785,47849,8936,18.7,2007/05/14(05:00)
2007,05,13,66167,55985,41961,14024,33.4,2007/05/13(03:00)
2007,05,12,66167,55185,44727,10458,23.4,2007/05/12(03:00)
2007,05,11,66167,56456,47697,8759,18.4,2007/05/11(23:00)
2007,05,10,66167,56014,47986,8028,16.7,2007/05/10(03:00)
2007,05,09,66167,57332,48240,9092,18.8,2007/05/09(03:00)
2007,05,08,66167,57014,48343,8671,17.9,2007/05/08(23:00)
2007,05,07,66167,57373,47691,9682,20.3,2007/05/07(23:00)
2007,05,06,66167,57354,41572,15782,38,2007/05/06(03:00)
2007,05,05,66167,58203,42554,15649,36.8,2007/05/05(03:00)
2007,05,04,66167,57417,46928,10489,22.4,2007/05/04(07:00)
2007,05,03,66167,57069,47818,9251,19.3,2007/05/03(23:00)
2007,05,02,66167,57283,46980,10303,21.9,2007/05/02(05:00)
2007,05,01,66167,58327,44748,13579,30.3,2007/05/01(03:00)
2007,04,30,66167,57561,46566,10995,23.6,2007/04/30(04:00)
2007,04,29,66167,56624,41734,14890,35.7,2007/04/29(23:00)
2007,04,28,66167,56654,43641,13013,29.8,2007/04/28(03:00)
2007,04,27,66167,58224,47380,10844,22.9,2007/04/27(03:00)
2007,04,26,66167,57737,47848,9889,20.7,2007/04/26(05:00)
2007,04,25,66167,58330,47768,10562,22.1,2007/04/25(23:00)
2007,04,24,66167,58205,48390,9815,20.3,2007/04/24(03:00)
2007,04,23,66167,57334,47957,9377,19.6,2007/04/23(03:00)
2007,04,22,66167,56513,43033,13480,31.3,2007/04/22(04:00)
2007,04,21,66167,58008,44603,13405,30.1,2007/04/21(23:00)
2007,04,20,66167,59785,48523,11262,23.2,2007/04/20(04:00)
2007,04,19,66167,59528,48635,10893,22.4,2007/04/19(03:00)
2007,04,18,66167,58630,49128,9502,19.3,2007/04/18(04:00)
2007,04,17,66167,59383,49416,9967,20.2,2007/04/17(23:00)
2007,04,16,66167,59777,49220,10557,21.4,2007/04/16(05:00)
2007,04,15,66167,58194,43540,14654,33.7,2007/04/15(23:00)
2007,04,14,66167,57476,45352,12124,26.7,2007/04/14(05:00)
2007,04,13,66167,58424,48678,9746,20,2007/04/13(23:00)
2007,04,12,66167,59474,48860,10614,21.7,2007/04/12(05:00)
2007,04,11,66167,59267,48804,10463,21.4,2007/04/11(23:00)
2007,04,10,66167,59199,49231,9968,20.2,2007/04/10(04:00)
2007,04,09,66167,58999,48927,10072,20.6,2007/04/09(23:00)
2007,04,08,66167,57834,44324,13510,30.5,2007/04/08(04:00)
2007,04,07,66167,57203,45996,11207,24.4,2007/04/07(23:00)
2007,04,06,66167,58963,49193,9770,19.9,2007/04/06(04:00)
2007,04,05,66167,59107,49793,9314,18.7,2007/04/05(23:00)
2007,04,04,66167,59598,50387,9211,18.3,2007/04/04(05:00)
2007,04,03,66167,59573,50750,8823,17.4,2007/04/03(23:00)
2007,04,02,66167,59499,50387,9112,18.1,2007/04/02(05:00)
2007,04,01,66167,59020,44458,14562,32.8,2007/04/01(23:00)
2007,03,31,66167,59261,46890,12371,26.4,2007/03/31(23:00)
2007,03,30,66167,61288,49895,11393,22.8,2007/03/30(23:00)
2007,03,29,66167,61252,50695,10557,20.8,2007/03/29(23:00)
2007,03,28,66167,60135,50364,9771,19.4,2007/03/28(23:00)
2007,03,27,66167,60132,50637,9495,18.8,2007/03/27(22:00)
2007,03,26,66167,59481,50495,8986,17.8,2007/03/26(23:00)
2007,03,25,66167,59765,45010,14755,32.8,2007/03/25(23:00)
2007,03,24,66167,59631,47642,11989,25.2,2007/03/24(23:00)
2007,03,23,66167,59652,50399,9253,18.4,2007/03/23(23:00)
2007,03,22,66167,59402,51596,7806,15.1,2007/03/22(23:00)
2007,03,21,66167,59703,51900,7803,15,2007/03/21(04:00)
2007,03,20,66167,59559,52064,7495,14.4,2007/03/20(23:00)
2007,03,19,66037,59200,51972,7228,13.9,2007/03/19(23:00)
2007,03,18,66037,58390,46116,12274,26.6,2007/03/18(23:00)
2007,03,17,66037,58505,48400,10105,20.9,2007/03/17(04:00)
2007,03,16,66037,59105,51638,7467,14.5,2007/03/16(23:00)
2007,03,15,66037,58692,51963,6729,12.9,2007/03/15(23:00)
2007,03,14,66037,59364,52311,7053,13.5,2007/03/14(23:00)
2007,03,13,66037,59828,52735,7093,13.5,2007/03/13(05:00)
2007,03,12,66037,59920,52923,6997,13.2,2007/03/12(23:00)
2007,03,11,66037,59419,47720,11699,24.5,2007/03/11(23:00)
2007,03,10,66037,59346,50077,9269,18.5,2007/03/10(06:00)
2007,03,09,66037,60522,52526,7996,15.2,2007/03/09(07:00)
2007,03,08,66037,60522,53245,7277,13.7,2007/03/08(23:00)
2007,03,07,66037,60383,54041,6342,11.7,2007/03/07(23:00)
2007,03,06,66037,60433,54396,6037,11.1,2007/03/06(07:00)
2007,03,05,66037,60290,53762,6528,12.1,2007/03/05(07:00)
2007,03,04,66037,59581,44937,14644,32.6,2007/03/04(23:00)
2007,03,03,66037,59006,47119,11887,25.2,2007/03/03(23:00)
2007,03,02,66037,59887,50297,9590,19.1,2007/03/02(03:00)
2007,03,01,66037,60006,48345,11661,24.1,2007/03/01(13:00)
2007,02,28,66037,60707,50771,9936,19.6,2007/02/28(23:00)
2007,02,27,65514,61099,51351,9748,19,2007/02/27(23:00)
2007,02,26,65514,60990,51578,9412,18.2,2007/02/26(07:00)
2007,02,25,65514,60286,46255,14031,30.3,2007/02/25(03:00)
2007,02,24,65514,60286,48844,11442,23.4,2007/02/24(07:00)
2007,02,23,65514,61454,52025,9429,18.1,2007/02/23(23:00)
2007,02,22,65514,61413,51563,9850,19.1,2007/02/22(23:00)
2007,02,21,65514,60916,50523,10393,20.6,2007/02/21(05:00)
2007,02,20,65514,60870,46246,14624,31.6,2007/02/20(06:00)
2007,02,19,65514,62785,39596,23189,58.6,2007/02/19(06:00)
2007,02,18,65514,62785,39596,23189,58.6,2007/02/18(23:00)
2007,02,17,65514,62274,45801,16473,36,2007/02/17(04:00)
2007,02,16,65514,62834,51247,11587,22.6,2007/02/16(07:00)
2007,02,15,65514,62571,53771,8800,16.4,2007/02/15(04:00)
2007,02,14,65514,62371,54222,8149,15,2007/02/14(23:00)
2007,02,13,65514,61595,53548,8047,15,2007/02/13(19:00)
2007,02,12,65514,61494,53266,8228,15.4,2007/02/12(23:00)
2007,02,11,65514,60116,47620,12496,26.2,2007/02/11(23:00)
2007,02,10,65514,59397,49842,9555,19.2,2007/02/10(23:00)
2007,02,09,65514,61754,52746,9008,17.1,2007/02/09(23:00)
2007,02,08,65514,61374,52495,8879,16.9,2007/02/08(07:00)
2007,02,07,65514,60532,52411,8121,15.5,2007/02/07(23:00)
2007,02,06,65514,60856,52646,8210,15.6,2007/02/06(00:00)
2007,02,05,65514,62359,53613,8746,16.3,2007/02/05(12:00)
2007,02,04,65514,63770,48825,14945,30.6,2007/02/04(01:00)
2007,02,03,65514,63716,52482,11234,21.4,2007/02/03(01:00)
2007,02,02,65514,63981,55071,8910,16.2,2007/02/02(11:00)
2007,02,01,65514,64281,55402,8879,16,2007/02/01(12:00)
2007,01,31,65514,64116,54626,9490,17.4,2007/01/31(11:00)
2007,01,30,65514,64482,54663,9819,18,2007/01/30(19:00)
2007,01,29,65514,63635,54090,9545,17.6,2007/01/29(11:00)
2007,01,28,65514,63462,48521,14941,30.8,2007/01/28(01:00)
2007,01,27,65514,63462,50696,12766,25.2,2007/01/27(23:00)
2007,01,26,65514,63928,53845,10083,18.7,2007/01/26(11:00)
2007,01,25,65514,63942,53636,10306,19.2,2007/01/25(11:00)
2007,01,24,65514,63942,53453,10489,19.6,2007/01/24(23:00)
2007,01,23,65514,63942,53683,10259,19.1,2007/01/23(11:00)
2007,01,22,65514,63924,53724,10200,19,2007/01/22(19:00)
2007,01,21,65514,62162,48293,13869,28.7,2007/01/21(01:00)
2007,01,20,65514,62162,50630,11532,22.8,2007/01/20(01:00)
2007,01,19,65514,62868,53927,8941,16.6,2007/01/19(11:00)
2007,01,18,65514,63118,54064,9054,16.7,2007/01/18(19:00)
2007,01,17,65514,63418,53672,9746,18.2,2007/01/17(02:00)
2007,01,16,65514,62543,54399,8144,15,2007/01/16(11:00)
2007,01,15,65514,61952,55066,6886,12.5,2007/01/15(11:00)
2007,01,14,65514,62628,49782,12846,25.8,2007/01/14(01:00)
2007,01,13,65514,63912,52184,11728,22.5,2007/01/13(01:00)
2007,01,12,65514,64831,54687,10144,18.5,2007/01/12(19:00)
2007,01,11,65514,64831,54657,10174,18.6,2007/01/11(11:00)
2007,01,10,65514,64831,54312,10519,19.4,2007/01/10(11:00)
2007,01,09,65514,65297,54683,10614,19.4,2007/01/09(11:00)
2007,01,08,65514,65607,54753,10854,19.8,2007/01/08(19:00)
2007,01,07,65514,65491,49141,16350,33.3,2007/01/07(01:00)
2007,01,06,65514,65491,51321,14170,27.6,2007/01/06(23:00)
2007,01,05,65514,65891,52616,13275,25.2,2007/01/05(11:00)
2007,01,04,65514,65909,52790,13119,24.9,2007/01/04(17:00)
2007,01,03,65534,66662,52861,13801,26.1,2007/01/03(11:00)
2007,01,02,65534,65585,51305,14280,27.8,2007/01/02(23:00)
2007,01,01,65534,65144,45610,19534,42.8,2007/01/01(23:00)
2006,12,31,65534,63830,47702,16128,33.8,2006/12/31(01:00)
2006,12,30,65534,63254,51396,11858,23.1,2006/12/30(01:00)
2006,12,29,65534,63840,54003,9837,18.2,2006/12/29(11:00)
2006,12,28,65534,64635,55508,9127,16.4,2006/12/28(18:00)
2006,12,27,65334,64330,53070,11260,21.2,2006/12/27(23:00)
2006,12,26,65534,64330,52176,12154,23.3,2006/12/26(23:00)
2006,12,25,65534,63021,47886,15135,31.6,2006/12/25(23:00)
2006,12,23,65534,62454,49919,12535,25.1,2006/12/23(01:00)
2006,12,22,65534,63797,53114,10683,20.1,2006/12/22(23:00)
2006,12,21,65534,65097,53788,11309,21,2006/12/21(23:00)
2006,12,20,65233,65047,53669,11378,21.2,2006/12/20(23:00)
2006,12,18,65233,63801,55248,8553,15.5,2006/12/18(19:00)
2006,12,17,65223,63062,48950,14112,28.8,2006/12/17(23:00)
2006,12,16,65233,62096,50458,11638,23.1,2006/12/16(23:00)
2006,12,15,65233,62884,53006,9878,18.6,2006/12/15(18:00)
2006,12,14,65233,63871,53361,10510,19.7,2006/12/14(18:00)
2006,12,13,65233,64144,52796,11348,21.5,2006/12/13(23:00)
2006,12,12,65233,63991,52941,11050,20.9,2006/12/12(23:00)
2006,12,11,65233,64092,54008,10084,18.7,2006/12/11(19:00)
2006,12,10,65233,62333,47885,14448,30.2,2006/12/10(23:00)
2006,12,09,65233,61086,50022,11064,22.1,2006/12/09(23:00)
2006,12,08,65233,60790,53267,7523,14.1,2006/12/08(18:00)
2006,12,07,65233,60697,53798,6899,12.8,2006/12/07(18:00)
2006,12,06,65233,60752,53425,7327,13.7,2006/12/06(23:00)
2006,12,05,65233,60533,53883,6650,12.3,2006/12/05(18:00)
2006,12,04,65233,60402,54505,5897,10.8,2006/12/04(18:00)
2006,12,03,65233,59817,48186,11631,24.1,2006/12/03(23:00)
2006,12,02,65233,59092,50181,8911,17.8,2006/12/02(23:00)
2006,12,01,65233,60334,51910,8424,16.2,2006/12/01(23:00)
2006,11,30,65233,60245,52071,8174,15.7,2006/11/30(23:00)
2006,11,29,65233,60056,51796,8260,15.9,2006/11/29(23:00)
2006,11,28,65223,60175,51062,9113,17.8,2006/11/28(19:00)
2006,11,27,65233,60510,50995,9515,18.7,2006/11/27(18:00)
2006,11,26,65233,60128,44446,15682,35.3,2006/11/26(23:00)
2006,11,25,65233,59849,47032,12817,27.3,2006/11/25(23:00)
2006,11,24,65233,61188,50708,10480,20.7,2006/11/24(23:00)
2006,11,23,65233,61178,51242,9936,19.4,2006/11/23(23:00)
2006,11,22,65233,60560,51111,9449,18.5,2006/11/22(23:00)
2006,11,21,65233,60048,50757,9291,18.3,2006/11/21(19:00)
2006,11,20,65233,59553,50554,8999,17.8,2006/11/20(23:00)
2006,11,19,65233,58870,44580,14290,32.1,2006/11/19(23:00)
2006,11,18,65233,59320,47631,11689,24.5,2006/11/18(23:00)
2006,11,17,65233,60611,51059,9552,18.7,2006/11/17(23:00)
2006,11,16,65233,60537,51631,8906,17.2,2006/11/16(19:00)
2006,11,15,65233,60369,50744,9625,19,2006/11/15(23:00)
2006,11,14,65233,59460,50868,8592,16.9,2006/11/14(19:00)
2006,11,13,65233,59049,49900,9149,18.3,2006/11/13(19:00)
2006,11,12,65233,58888,44066,14822,33.6,2006/11/12(23:00)
2006,11,11,65233,58819,46329,12490,27,2006/11/11(23:00)
2006,11,10,65233,59327,49224,10103,20.5,2006/11/10(23:00)
2006,11,09,65233,59236,49078,10158,20.7,2006/11/09(23:00)
2006,11,08,65233,59432,48980,10452,21.3,2006/11/08(23:00)
2006,11,07,65233,59914,50350,9564,19,2006/11/07(19:00)
2006,11,06,65233,59258,49437,9821,19.9,2006/11/06(19:00)
2006,11,05,65233,59334,42362,16972,40.1,2006/11/05(23:00)
2006,11,04,65233,58996,44213,14783,33.4,2006/11/04(23:00)
2006,11,03,65233,60264,47795,12469,26.1,2006/11/03(19:00)
2006,11,02,65233,60315,48319,11996,24.8,2006/11/02(19:00)
2006,11,01,65233,61210,47214,13996,29.6,2006/11/01(19:00)
2006,10,31,65233,61315,47644,13671,28.7,2006/10/31(19:00)
2006,10,30,65233,60965,47464,13501,28.4,2006/10/30(19:00)
2006,10,29,65233,60965,41357,19608,47.4,2006/10/29(23:00)
2006,10,28,65233,60627,43887,16740,38.1,2006/10/28(23:00)
2006,10,27,65233,60910,47333,13577,28.7,2006/10/27(19:00)
2006,10,26,65233,61195,48070,13125,27.3,2006/10/26(19:00)
2006,10,25,65233,60934,47061,13873,29.5,2006/10/25(19:00)
2006,10,24,65233,60758,47274,13484,28.5,2006/10/24(18:00)
2006,10,23,65233,60869,47284,13585,28.7,2006/10/23(19:00)
2006,10,22,65233,59546,41055,18491,45,2006/10/22(23:00)
2006,10,21,65233,58415,43245,15170,35.1,2006/10/21(23:00)
2006,10,20,65233,59393,48083,11310,23.5,2006/10/20(19:00)
2006,10,19,65233,59674,48982,10692,21.8,2006/10/19(19:00)
2006,10,18,65233,59280,48372,10908,22.6,2006/10/18(19:00)
2006,10,17,65233,59240,49033,10207,20.8,2006/10/17(19:00)
2006,10,16,65233,59035,48175,10860,22.5,2006/10/16(19:00)
2006,10,15,65233,58349,40654,17695,43.5,2006/10/15(23:00)
2006,10,14,65233,57971,43272,14699,34,2006/10/14(23:00)
2006,10,13,65233,59333,47578,11755,24.7,2006/10/13(19:00)
2006,10,12,65233,59537,47967,11570,24.1,2006/10/12(19:00)
2006,10,11,65233,59390,47502,11888,25,2006/10/11(19:00)
2006,10,10,65233,59390,48071,11319,23.5,2006/10/10(19:00)
2006,10,09,65233,59537,46515,13022,28,2006/10/09(20:00)
2006,10,08,65233,60141,36954,23187,62.7,2006/10/08(23:00)
2006,10,07,65233,60706,34247,26459,77.3,2006/10/07(23:00)
2006,10,06,65233,60706,31589,29117,92.2,2006/10/06(22:00)
2006,10,05,65233,59282,34557,24725,71.5,2006/10/05(01:00)
2006,10,04,65233,58733,39944,18789,47,2006/10/04(20:00)
2006,10,03,65233,60692,43018,17674,41.1,2006/10/03(20:00)
2006,10,02,65233,59801,46204,13597,29.4,2006/10/02(20:00)
2006,10,01,64778,59859,41396,18463,44.6,2006/10/01(20:00)
2006,09,30,64778,59446,43453,15993,36.8,2006/09/30(12:00)
2006,09,29,64778,59244,47725,11519,24.1,2006/09/29(20:00)
2006,09,28,64778,58040,48773,9267,19,2006/09/28(20:00)
2006,09,27,64778,56869,48401,8468,17.5,2006/09/27(20:00)
2006,09,26,64778,57991,48468,9523,19.6,2006/09/26(20:00)
2006,09,25,64778,59396,48333,11063,22.9,2006/09/25(20:00)
2006,09,24,64778,58950,40233,18717,46.5,2006/09/24(20:00)
2006,09,23,64778,58295,43395,14900,34.3,2006/09/23(12:00)
2006,09,22,64778,59247,48835,10412,21.3,2006/09/22(20:00)
2006,09,21,64778,59445,49008,10437,21.3,2006/09/21(20:00)
2006,09,20,64778,60205,47810,12395,25.9,2006/09/20(20:00)
2006,09,19,64778,60205,48500,11705,24.1,2006/09/19(20:00)
2006,09,18,64778,60270,46980,13290,28.3,2006/09/18(20:00)
2006,09,17,64778,60010,39688,20322,51.2,2006/09/17(23:00)
2006,09,16,64778,59703,43151,16552,38.4,2006/09/16(12:00)
2006,09,15,64778,60735,47600,13135,27.6,2006/09/15(20:00)
2006,09,14,64778,60596,48193,12403,25.7,2006/09/14(19:00)
2006,09,13,64778,60946,47760,13186,27.6,2006/09/13(20:00)
2006,09,12,64778,61046,47826,13220,27.6,2006/09/12(20:00)
2006,09,11,64778,60906,46858,14048,30,2006/09/11(20:00)
2006,09,10,64778,61216,39595,21621,54.6,2006/09/10(23:00)
2006,09,09,64778,61867,44387,17480,39.4,2006/09/09(03:00)
2006,09,08,64778,62532,48718,13814,28.4,2006/09/08(15:00)
2006,09,07,64778,62103,48666,13437,27.6,2006/09/07(17:00)
2006,09,06,64778,61491,47912,13579,28.3,2006/09/06(15:00)
2006,09,05,64778,61642,48863,12779,26.2,2006/09/05(15:00)
2006,09,04,64778,61460,51744,9716,18.8,2006/09/04(15:00)
2006,09,03,64778,59435,42369,17066,40.3,2006/09/03(20:00)
2006,09,02,64778,60430,47149,13281,28.2,2006/09/02(15:00)
2006,09,01,64778,63007,51674,11333,21.9,2006/09/01(15:00)
2006,08,31,64778,64725,52399,12326,23.5,2006/08/31(15:00)
2006,08,30,64778,64725,52076,12649,24.3,2006/08/30(15:00)
2006,08,29,64778,64725,53821,10904,20.3,2006/08/29(15:00)
2006,08,28,64778,64725,54707,10018,18.3,2006/08/28(15:00)
2006,08,27,64778,63877,43742,20135,46,2006/08/27(21:00)
2006,08,26,64778,64368,50038,14330,28.6,2006/08/26(15:00)
2006,08,25,64778,65226,55853,9373,16.8,2006/08/25(15:00)
2006,08,24,64778,64395,56659,7736,13.7,2006/08/24(15:00)
2006,08,23,64778,64966,56230,8736,15.5,2006/08/23(15:00)
2006,08,22,64778,64966,56141,8825,15.7,2006/08/22(15:00)
2006,08,21,64778,65226,55183,10043,18.2,2006/08/21(15:00)
2006,08,20,64778,64043,42970,21073,49,2006/08/20(21:00)
2006,08,19,64778,64063,46107,17956,38.9,2006/08/19(12:00)
2006,08,18,64778,65183,54061,11122,20.6,2006/08/18(12:00)
2006,08,17,64778,65183,56531,8652,15.3,2006/08/17(12:00)
2006,08,16,64778,65183,58994,6189,10.5,2006/08/16(12:00)
2006,08,15,64778,63890,52087,11803,22.7,2006/08/15(21:00)
2006,08,14,64778,63640,57270,6370,11.1,2006/08/14(15:00)
2006,08,13,64778,62925,47046,15879,33.8,2006/08/13(21:00)
2006,08,12,64778,63640,50995,12645,24.8,2006/08/12(12:00)
2006,08,11,64778,63865,55796,8069,14.5,2006/08/11(12:00)
2006,08,10,64504,62883,57242,5641,9.9,2006/08/10(15:00)
2006,08,09,64504,62529,57063,5466,9.6,2006/08/09(15:00)
2006,08,08,64504,62851,56169,6682,11.9,2006/08/08(15:00)
2006,08,07,64504,63421,54798,8623,15.7,2006/08/07(15:00)
2006,08,06,64504,63119,45705,17414,38.1,2006/08/06(21:00)
2006,08,05,64504,62767,48765,14002,28.7,2006/08/05(12:00)
2006,08,04,64504,63099,53056,10043,18.9,2006/08/04(15:00)
2006,08,03,64504,63119,51775,11344,21.9,2006/08/03(15:00)
2006,08,02,64504,63119,49300,13819,28,2006/08/02(15:00)
2006,08,01,64504,62810,48352,14458,29.9,2006/08/01(15:00)
2006,07,31,64504,62771,48135,14636,30.4,2006/07/31(15:00)
2006,07,30,64504,62283,42988,19295,44.9,2006/07/30(21:00)
2006,07,29,64504,63481,44351,19130,43.1,2006/07/29(12:00)
2006,07,28,64504,62936,48913,14023,28.7,2006/07/28(12:00)
2006,07,27,64504,63193,48852,14341,29.4,2006/07/27(12:00)
2006,07,26,64504,63547,48163,15384,31.9,2006/07/26(12:00)
2006,07,25,64504,63226,49225,14001,28.4,2006/07/25(12:00)
2006,07,24,64504,63278,48130,15148,31.5,2006/07/24(12:00)
2006,07,23,64504,62183,40194,21989,54.7,2006/07/23(21:00)
2006,07,22,64504,62733,44570,18163,40.8,2006/07/22(12:00)
2006,07,21,64504,62863,47547,15316,32.2,2006/07/21(12:00)
2006,07,20,64504,62397,47025,15372,32.7,2006/07/20(12:00)
2006,07,19,64504,61908,46456,15452,33.3,2006/07/19(12:00)
2006,07,18,64504,61908,47234,14674,31.1,2006/07/18(14:00)
2006,07,17,64504,61927,42056,19871,47.2,2006/07/17(21:00)
2006,07,16,64504,61029,40162,20867,52,2006/07/16(21:00)
2006,07,15,64504,60881,48510,12371,25.5,2006/07/15(12:00)
2006,07,14,64504,63100,55263,7837,14.2,2006/07/14(15:00)
2006,07,13,64504,61665,53912,7753,14.4,2006/07/13(15:00)
2006,07,12,64504,61665,52533,9132,17.4,2006/07/12(15:00)
2006,07,11,64504,61068,50439,10629,21.1,2006/07/11(15:00)
2006,07,10,64504,60613,48334,12279,25.4,2006/07/10(12:00)
2006,07,09,64504,59168,42430,16738,39.4,2006/07/09(21:00)
2006,07,08,64504,58698,45277,13421,29.6,2006/07/08(12:00)
2006,07,07,64504,60259,49154,11105,22.6,2006/07/07(15:00)
2006,07,06,64504,58970,47377,11593,24.5,2006/07/06(15:00)
2006,07,05,64504,59290,48662,10628,21.8,2006/07/05(15:00)
2006,07,04,64504,59485,49150,10335,21,2006/07/04(15:00)
2006,07,03,64054,59393,49629,9764,19.7,2006/07/03(17:00)
2006,07,02,64504,58413,40588,17825,43.9,2006/07/02(21:00)
2006,07,01,64504,58158,44307,13851,31.3,2006/07/01(12:00)
2006,06,30,64504,58249,51308,6941,13.5,2006/06/30(15:00)
2006,06,29,64504,58860,51941,6919,13.3,2006/06/29(15:00)
2006,06,28,64504,58391,51310,7081,13.8,2006/06/28(15:00)
2006,06,27,64504,58574,49538,9036,18.2,2006/06/27(15:00)
2006,06,26,64504,57494,48657,8837,18.2,2006/06/26(17:00)
2006,06,25,64504,57794,40399,17395,43.1,2006/06/25(21:00)
2006,06,24,64504,56135,44180,11955,27.1,2006/06/24(12:00)
2006,06,23,64504,58187,50375,7812,15.5,2006/06/23(15:00)
2006,06,22,64504,58473,49337,9136,18.5,2006/06/22(17:00)
2006,06,21,64504,58473,48581,9892,20.4,2006/06/21(15:00)
2006,06,20,64249,57785,49126,8659,17.6,2006/06/20(15:00)
2006,06,19,64249,58081,49076,9005,18.3,2006/06/19(15:00)
2006,06,18,64249,58019,40016,18003,45,2006/06/18(21:00)
2006,06,17,64249,57339,43198,14141,32.7,2006/06/17(12:00)
2006,06,16,64249,59538,47394,12144,25.6,2006/06/16(15:00)
2006,06,15,64249,58697,46680,12017,25.7,2006/06/15(15:00)
2006,06,14,64249,58114,46127,11987,26,2006/06/14(15:00)
2006,06,13,64249,58155,48818,9337,19.1,2006/06/13(16:00)
2006,06,12,64249,57925,47275,10650,22.5,2006/06/12(17:00)
2006,06,11,64249,57962,39437,18525,47,2006/06/11(23:00)
2006,06,10,64249,57275,43850,13425,30.6,2006/06/10(12:00)
2006,06,09,64249,58463,47086,11377,24.2,2006/06/09(15:00)
2006,06,08,64249,57831,46989,10842,23.1,2006/06/08(15:00)
2006,06,07,64249,57031,47739,9292,19.5,2006/06/07(15:00)
2006,06,06,64249,57761,43371,14390,33.2,2006/06/06(21:00)
2006,06,05,64249,57561,46939,10622,22.6,2006/06/05(15:00)
2006,06,04,64249,56259,39332,16927,43,2006/06/04(23:00)
2006,06,03,64249,55759,43710,12049,27.6,2006/06/03(15:00)
2006,06,02,64249,57034,48558,8476,17.5,2006/06/02(15:00)
2006,06,01,64249,57469,46408,11061,23.8,2006/06/01(01:00)
2006,05,31,64249,58264,42487,15777,37.1,2006/05/31(21:00)
2006,05,30,64249,57733,46264,11469,24.8,2006/05/30(15:00)
2006,05,29,64249,58291,45432,12859,28.3,2006/05/29(21:00)
2006,05,28,64249,57095,39532,17563,44.4,2006/05/28(23:00)
2006,05,27,64249,57261,42506,14755,34.7,2006/05/27(23:00)
2006,05,26,64249,56487,45826,10661,23.3,2006/05/26(15:00)
2006,05,25,64249,57051,45687,11364,24.9,2006/05/25(21:00)
2006,05,24,64249,57131,45761,11370,24.8,2006/05/24(21:00)
2006,05,23,64249,56589,45574,11015,24.2,2006/05/23(23:00)
2006,05,22,64249,56294,46070,10224,22.2,2006/05/22(17:00)
2006,05,21,64249,56270,39744,16526,41.6,2006/05/21(23:00)
2006,05,20,64249,56713,42230,14483,34.3,2006/05/20(23:00)
2006,05,19,64249,57110,45587,11523,25.3,2006/05/19(23:00)
2006,05,18,64249,55947,46043,9904,21.5,2006/05/18(21:00)
2006,05,17,64249,58440,45541,12899,28.3,2006/05/17(21:00)
2006,05,16,64249,58136,45839,12297,26.8,2006/05/16(21:00)
2006,05,15,64249,57586,45423,12163,26.8,2006/05/15(23:00)
2006,05,14,63754,57755,40419,17336,42.9,2006/05/14(23:00)
2006,05,13,63754,57499,42908,14591,34,2006/05/13(23:00)
2006,05,12,63754,57958,46146,11812,25.6,2006/05/12(23:00)
2006,05,11,63754,57238,46062,11176,24.3,2006/05/11(23:00)
2006,05,10,63754,56745,45518,11227,24.7,2006/05/10(23:00)
2006,05,09,63754,57206,46201,11005,23.8,2006/05/09(20:00)
2006,05,08,63754,57374,45387,11987,26.4,2006/05/08(23:00)
2006,05,07,63754,57420,39613,17807,45,2006/05/07(23:00)
2006,05,06,63754,57290,41850,15440,36.9,2006/05/06(23:00)
2006,05,05,63754,56605,41906,14699,35.1,2006/05/05(23:00)
2006,05,04,63754,57515,45065,12450,27.6,2006/05/04(23:00)
2006,05,03,63754,57474,45899,11575,25.2,2006/05/03(23:00)
2006,05,02,63754,57124,45519,11605,25.5,2006/05/02(23:00)
2006,05,01,63754,56960,41441,15519,37.4,2006/05/01(23:00)
2006,04,29,63754,57392,43444,13948,32.1,2006/04/29(23:00)
2006,04,28,63754,58265,46540,11725,25.2,2006/04/28(23:00)
2006,04,27,63754,57548,46994,10554,22.5,2006/04/27(23:00)
2006,04,26,63754,57638,47142,10496,22.3,2006/04/26(23:00)
2006,04,25,63754,57144,47495,9649,20.3,2006/04/25(23:00)
2006,04,24,63504,56636,47670,8966,18.8,2006/04/24(23:00)
2006,04,23,63504,56096,42621,13475,31.6,2006/04/23(23:00)
2006,04,22,63504,56492,44708,11784,26.4,2006/04/22(23:00)
2006,04,21,63504,58282,47257,11025,23.3,2006/04/21(23:00)
2006,04,20,63504,57108,48484,8624,17.8,2006/04/20(23:00)
2006,04,19,63504,57122,48325,8797,18.2,2006/04/19(23:00)
2006,04,18,63504,56562,46875,9687,20.7,2006/04/18(23:00)
2006,04,17,63504,56804,47487,9317,19.6,2006/04/17(23:00)
2006,04,16,63504,56653,42241,14412,34.1,2006/04/16(23:00)
2006,04,15,63504,56443,44773,11670,26.1,2006/04/15(23:00)
2006,04,14,63504,57192,47119,10073,21.4,2006/04/14(22:00)
2006,04,13,63504,56536,48092,8444,17.6,2006/04/13(23:00)
2006,04,12,63504,55882,47009,8873,18.9,2006/04/12(23:00)
2006,04,11,63054,55642,47262,8380,17.7,2006/04/11(23:00)
2006,04,10,63504,55610,47305,8305,17.6,2006/04/10(23:00)
2006,04,09,63504,54260,41987,12273,29.2,2006/04/09(23:00)
2006,04,08,63504,54583,44628,9955,22.3,2006/04/08(23:00)
2006,04,07,63504,56354,47859,8495,17.8,2006/04/07(23:00)
2006,04,06,63504,55650,48343,7307,15.1,2006/04/06(23:00)
2006,04,05,63504,56065,47677,8388,17.6,2006/04/05(23:00)
2006,04,04,63504,54576,48148,6428,13.4,2006/04/04(23:00)
2006,04,03,63504,56044,47881,8163,17,2006/04/03(23:00)
2006,04,02,63003,55697,43108,12589,29.2,2006/04/02(23:00)
2006,04,01,63003,55897,45353,10544,23.2,2006/04/01(23:00)
2006,03,31,63003,56102,48661,7441,15.3,2006/03/31(23:00)
2006,03,30,63003,56632,49548,7084,14.3,2006/03/30(23:00)
2006,03,29,63003,56882,49664,7218,14.5,2006/03/29(23:00)
2006,03,28,63003,55733,50152,5581,11.1,2006/03/28(23:00)
2006,03,27,63003,55479,48572,6907,14.2,2006/03/27(23:00)
2006,03,26,63003,53509,43107,10402,24.1,2006/03/26(23:00)
2006,03,25,63003,53364,45443,7921,17.4,2006/03/25(23:00)
2006,03,24,63003,55806,48988,6818,13.9,2006/03/24(23:00)
2006,03,23,63003,56833,49229,7604,15.4,2006/03/23(23:00)
2006,03,22,63003,56955,48516,8439,17.4,2006/03/22(23:00)
2006,03,21,63003,57500,48644,8856,18.2,2006/03/21(23:00)
2006,03,20,63003,56800,49531,7269,14.7,2006/03/20(23:00)
2006,03,19,63003,54844,44031,10813,24.6,2006/03/19(23:00)
2006,03,18,63003,55204,46276,8928,19.3,2006/03/18(23:00)
2006,03,17,63003,56568,49169,7399,15,2006/03/17(23:00)
2006,03,16,63003,57573,50652,6921,13.7,2006/03/16(23:00)
2006,03,15,63003,57529,49855,7674,15.4,2006/03/15(23:00)
2006,03,14,63003,57418,51172,6246,12.2,2006/03/14(23:00)
2006,03,13,63003,57468,51722,5746,11.1,2006/03/13(23:00)
2006,03,12,63003,57449,45784,11665,25.5,2006/03/12(23:00)
2006,03,11,63003,57540,46056,11484,24.9,2006/03/11(23:00)
2006,03,10,63003,58624,48410,10214,21.1,2006/03/10(23:00)
2006,03,09,63003,58911,49217,9694,19.7,2006/03/09(23:00)
2006,03,08,63003,58780,49450,9330,18.9,2006/03/08(23:00)
2006,03,07,63003,58852,49436,9416,19,2006/03/07(23:00)
2006,03,06,63003,57740,49665,8075,16.3,2006/03/06(23:00)
2006,03,05,63003,56717,44419,12298,27.7,2006/03/05(01:00)
2006,03,04,63003,58057,47550,10507,22.1,2006/03/04(23:00)
2006,03,03,63003,58903,51123,7780,15.2,2006/03/03(23:00)
2006,03,02,63003,58643,51460,7183,14,2006/03/02(23:00)
2006,03,01,63003,58586,48158,10428,21.7,2006/03/01(23:00)
2006,02,28,63003,59011,50352,8659,17.2,2006/02/28(23:00)
2006,02,27,63003,59136,50942,8194,16.1,2006/02/27(23:00)
2006,02,26,63003,58611,45237,13374,29.6,2006/02/26(23:00)
2006,02,25,63003,59243,46810,12433,26.6,2006/02/25(23:00)
2006,02,24,63003,61126,50030,11096,22.2,2006/02/24(23:00)
2006,02,23,62753,60677,50854,9823,19.3,2006/02/23(23:00)
2006,02,22,62753,60783,51047,9736,19.1,2006/02/22(23:00)
2006,02,21,62753,61575,50252,11323,22.5,2006/02/21(23:00)
2006,02,20,62753,61566,50471,11095,22,2006/02/20(23:00)
2006,02,19,62753,60880,46695,14185,30.4,2006/02/19(01:00)
2006,02,18,62753,61886,50148,11738,23.4,2006/02/18(01:00)
2006,02,17,62753,62257,52206,10051,19.3,2006/02/17(00:00)
2006,02,16,62753,61789,51768,10021,19.4,2006/02/16(23:00)
2006,02,15,62753,61490,50727,10763,21.2,2006/02/15(23:00)
2006,02,14,62753,62622,50606,12016,23.7,2006/02/14(23:00)
2006,02,13,62753,62771,51141,11630,22.7,2006/02/13(11:00)
2006,02,12,62260,62217,47074,15143,32.2,2006/02/12(23:00)
2006,02,11,62260,61942,49660,12282,24.7,2006/02/11(01:00)
2006,02,10,62260,63033,52370,10663,20.4,2006/02/10(12:00)
2006,02,09,62260,63033,53139,9894,18.6,2006/02/09(12:00)
2006,02,08,62260,61873,53397,8476,15.9,2006/02/08(23:00)
2006,02,07,62260,61673,52567,9106,17.3,2006/02/07(23:00)
2006,02,06,62260,61898,52703,9195,17.4,2006/02/06(12:00)
2006,02,05,62260,62048,48937,13111,26.8,2006/02/05(01:00)
2006,02,04,62260,63060,51099,11961,23.4,2006/02/04(01:00)
2006,02,03,62260,62935,53262,9673,18.2,2006/02/03(19:00)
2006,02,02,62260,62094,51455,10639,20.7,2006/02/02(00:00)
2006,02,01,62260,62094,50046,12048,24.1,2006/02/01(00:00)
2006,01,31,62260,62094,44351,17743,40,2006/01/31(23:00)
2006,01,30,62260,62228,40115,22113,55.1,2006/01/30(23:00)
2006,01,29,62260,61768,39237,22531,57.4,2006/01/29(01:00)
2006,01,28,62260,62228,44859,17369,38.7,2006/01/28(01:00)
2006,01,27,62260,62744,49129,13615,27.7,2006/01/27(01:00)
2006,01,26,62260,62510,51551,10959,21.3,2006/01/26(23:00)
2006,01,25,62260,62510,52593,9917,18.9,2006/01/25(00:00)
2006,01,24,62260,62417,52999,9418,17.8,2006/01/24(19:00)
2006,01,23,62260,62510,52671,9839,18.7,2006/01/23(19:00)
2006,01,22,62260,62483,47348,15135,32,2006/01/22(23:00)
2006,01,21,62260,62483,49124,13359,27.2,2006/01/21(00:00)
2006,01,20,62260,62353,51127,11226,22,2006/01/20(00:00)
2006,01,19,62260,62483,51473,11010,21.4,2006/01/19(00:00)
2006,01,18,62260,62224,51500,10724,20.8,2006/01/18(23:00)
2006,01,17,62260,62085,51457,10628,20.7,2006/01/17(19:00)
2006,01,16,62260,62085,51947,10138,19.5,2006/01/16(19:00)
2006,01,15,62260,61821,46009,15812,34.4,2006/01/15(01:00)
2006,01,14,62260,61146,48242,12904,26.7,2006/01/14(01:00)
2006,01,13,62260,61601,51549,10052,19.5,2006/01/13(12:00)
2006,01,12,62260,61876,52493,9383,17.9,2006/01/12(19:00)
2006,01,11,62260,61695,52545,9150,17.4,2006/01/11(11:00)
2006,01,10,62260,60986,52715,8271,15.7,2006/01/10(19:00)
2006,01,09,62260,61786,53788,7998,14.9,2006/01/09(19:00)
2006,01,08,62260,61118,49286,11832,24,2006/01/08(01:00)
2006,01,07,62260,61749,51620,10129,19.6,2006/01/07(01:00)
2006,01,06,62260,62984,54020,8964,16.6,2006/01/06(12:00)
2006,01,05,62260,63503,54212,9291,17.1,2006/01/05(19:00)
2006,01,04,62260,63679,53740,9939,18.5,2006/01/04(18:00)
2006,01,03,62260,64439,52460,11979,22.8,2006/01/03(19:00)
2006,01,02,62259,64439,50203,14236,28.4,2006/01/02(23:00)
2006,01,01,62259,64414,44836,19578,43.7,2006/01/01(01:00)
2005,12,31,62259,64064,48339,15725,32.5,2005/12/31(01:00)
2005,12,30,62259,64064,50941,13123,25.8,2005/12/30(11:00)
2005,12,29,62259,64065,52570,11495,21.9,2005/12/29(12:00)
2005,12,28,62259,63065,53366,9699,18.2,2005/12/28(12:00)
2005,12,27,62259,63065,53809,9256,17.2,2005/12/27(19:00)
2005,12,26,62259,64065,53935,10130,18.8,2005/12/26(19:00)
2005,12,25,62259,63777,47881,15896,33.2,2005/12/25(01:00)
2005,12,24,62259,62785,50737,12048,23.7,2005/12/24(01:00)
2005,12,23,62259,62480,52786,9694,18.4,2005/12/23(01:00)
2005,12,22,62259,60847,53591,7256,13.5,2005/12/22(19:00)
2005,12,21,62259,60452,54154,6298,11.6,2005/12/21(18:00)
2005,12,20,62241,60409,53700,6709,12.5,2005/12/20(19:00)
2005,12,19,62241,61961,54451,7510,13.8,2005/12/19(19:00)
2005,12,18,62241,60708,49567,11141,22.5,2005/12/18(01:00)
2005,12,17,62241,60773,51395,9378,18.2,2005/12/17(23:00)
2005,12,16,62241,60561,52799,7762,14.7,2005/12/16(23:00)
2005,12,15,62241,60609,53352,7257,13.6,2005/12/15(19:00)
2005,12,14,62241,58865,53330,5535,10.4,2005/12/14(00:00)
2005,12,13,62241,57637,53789,3848,7.2,2005/12/13(19:00)
2005,12,12,62241,57234,53970,3264,6,2005/12/12(19:00)
2005,12,11,62241,55840,47081,8759,18.6,2005/12/11(01:00)
2005,12,10,62241,56437,49138,7299,14.9,2005/12/10(01:00)
2005,12,09,62241,57746,51768,5978,11.5,2005/12/09(19:00)
2005,12,08,62241,57634,52468,5166,9.8,2005/12/08(19:00)
2005,12,07,62241,57504,51809,5695,11,2005/12/07(23:00)
2005,12,06,62241,58214,52236,5978,11.4,2005/12/06(19:00)
2005,12,05,62241,58608,52511,6097,11.6,2005/12/05(19:00)
2005,12,04,62241,57684,45864,11820,25.8,2005/12/04(23:00)
2005,12,03,62241,57684,47277,10407,22,2005/12/03(00:00)
2005,12,02,62241,58323,49817,8506,17.1,2005/12/02(23:00)
2005,12,01,62241,57449,49095,8354,17,2005/12/01(23:00)
2005,11,30,62241,57508,49589,7919,16,2005/11/30(23:00)
2005,11,29,62241,57324,49402,7922,16,2005/11/29(19:00)
2005,11,28,62241,57260,48733,8527,17.5,2005/11/28(19:00)
2005,11,27,62241,57479,43518,13961,32.1,2005/11/27(23:00)
2005,11,26,62241,57235,45568,11667,25.6,2005/11/26(23:00)
2005,11,25,62241,57739,48663,9076,18.7,2005/11/25(23:00)
2005,11,24,62241,57659,49231,8428,17.1,2005/11/24(23:00)
2005,11,23,62241,58480,48987,9493,19.4,2005/11/23(23:00)
2005,11,22,62241,58595,49982,8613,17.2,2005/11/22(19:00)
2005,11,21,62241,58430,49171,9259,18.8,2005/11/21(23:00)
2005,11,20,62241,58251,43995,14256,32.4,2005/11/20(01:00)
2005,11,19,62241,58706,46249,12457,26.9,2005/11/19(19:00)
2005,11,18,62241,57667,49125,8542,17.4,2005/11/18(19:00)
2005,11,17,62241,57139,49336,7803,15.8,2005/11/17(19:00)
2005,11,16,62241,57650,48741,8909,18.3,2005/11/16(23:00)
2005,11,15,62242,57905,48663,9242,19,2005/11/15(19:00)
2005,11,14,62241,57538,47732,9806,20.5,2005/11/14(19:00)
2005,11,13,62241,57177,41776,15401,36.9,2005/11/13(23:00)
2005,11,12,62241,56862,44006,12856,29.2,2005/11/12(23:00)
2005,11,11,62241,57872,46163,11709,25.4,2005/11/11(23:00)
2005,11,10,62241,57773,46363,11410,24.6,2005/11/10(19:00)
2005,11,09,62241,57773,46537,11236,24.1,2005/11/09(23:00)
2005,11,08,62241,57223,46854,10369,22.1,2005/11/08(19:00)
2005,11,07,62242,57700,46169,11531,25,2005/11/07(19:00)
2005,11,06,62241,57832,40575,17257,42.5,2005/11/06(23:00)
2005,11,04,62242,56963,45801,11162,24.4,2005/11/04(23:00)
2005,11,03,62241,57114,45929,11185,24.4,2005/11/03(23:00)
2005,11,02,62241,57521,46096,11425,24.8,2005/11/02(23:00)
2005,11,01,62241,57525,46085,11440,24.8,2005/11/01(23:00)
2005,10,31,62241,58142,46111,12031,26.1,2005/10/31(23:00)
2005,10,30,62241,57970,41053,16917,41.2,2005/10/30(23:00)
2005,10,29,62241,57898,42952,14946,34.8,2005/10/29(23:00)
2005,10,28,62241,57852,45867,11985,26.1,2005/10/28(23:00)
2005,10,27,62241,57681,46267,11414,24.7,2005/10/27(19:00)
2005,10,26,62241,55404,45782,9622,21,2005/10/26(23:00)
2005,10,25,62241,55638,45859,9779,21.3,2005/10/25(23:00)
2005,10,23,62241,56239,40636,15603,38.4,2005/10/23(23:00)
2005,10,22,62241,56753,43191,13562,31.4,2005/10/22(23:00)
2005,10,21,62241,56566,45289,11277,24.9,2005/10/21(23:00)
2005,10,20,62241,56055,45534,10521,23.1,2005/10/20(19:00)
2005,10,19,62241,55956,44963,10993,24.4,2005/10/19(23:00)
2005,10,18,62241,56145,45096,11049,24.5,2005/10/18(19:00)
2005,10,17,62241,55017,44638,10379,23.3,2005/10/17(19:00)
2005,10,16,62241,55187,39174,16013,40.9,2005/10/16(23:00)
2005,10,15,62241,56084,41114,14970,36.4,2005/10/15(23:00)
2005,10,14,62241,56267,44539,11728,26.3,2005/10/14(19:00)
2005,10,13,62241,56665,45395,11270,24.8,2005/10/13(20:00)
2005,10,12,62241,56465,44183,12282,27.8,2005/10/12(20:00)
2005,10,11,62241,57018,45034,11984,26.6,2005/10/11(20:00)
2005,10,10,62241,56273,44716,11557,25.8,2005/10/10(20:00)
2005,10,09,62241,55778,39262,16516,42.1,2005/10/09(23:00)
2005,10,08,62241,55335,41828,13507,32.3,2005/10/08(23:00)
2005,10,07,62241,54719,44575,10144,22.8,2005/10/07(20:00)
2005,10,06,62241,55469,44901,10568,23.5,2005/10/06(20:00)
2005,10,05,62241,56040,44433,11607,26.1,2005/10/05(20:00)
2005,10,04,62241,55929,44466,11463,25.8,2005/10/04(20:00)
2005,10,03,62241,55344,40272,15072,37.4,2005/10/03(23:00)
2005,10,02,62241,55463,37558,17905,47.7,2005/10/02(23:00)
2005,10,01,62241,55798,41891,13907,33.2,2005/10/01(12:00)
2005,09,30,61737,56526,45574,10952,24,2005/09/30(20:00)
2005,09,29,61737,56256,45851,10405,22.7,2005/09/29(20:00)
2005,09,28,61737,56028,45383,10645,23.5,2005/09/28(20:00)
2005,09,27,61737,55934,46012,9922,21.6,2005/09/27(20:00)
2005,09,26,61737,55934,45914,10020,21.8,2005/09/26(20:00)
2005,09,25,61737,54067,38327,15740,41.1,2005/09/25(20:00)
2005,09,24,61737,54031,42017,12014,28.6,2005/09/24(12:00)
2005,09,23,61737,54784,45643,9141,20,2005/09/23(20:00)
2005,09,22,61737,55714,45194,10520,23.3,2005/09/22(20:00)
2005,09,21,61737,56406,43757,12649,28.9,2005/09/21(20:00)
2005,09,20,61737,56734,40105,16629,41.5,2005/09/20(20:00)
2005,09,19,61737,56721,33350,23371,70.1,2005/09/19(23:00)
2005,09,18,61737,56721,31214,25507,81.7,2005/09/18(23:00)
2005,09,17,61737,56198,34880,21318,61.1,2005/09/17(01:00)
2005,09,16,61737,55741,44251,11490,26,2005/09/16(12:00)
2005,09,15,61737,55590,46901,8689,18.5,2005/09/15(20:00)
2005,09,14,61737,55070,47388,7682,16.2,2005/09/14(15:00)
2005,09,13,61737,56029,49152,6877,14,2005/09/13(15:00)
2005,09,12,61737,56469,51162,5307,10.4,2005/09/12(15:00)
2005,09,11,61737,55777,42384,13393,31.6,2005/09/11(20:00)
2005,09,10,61737,55677,45088,10589,23.5,2005/09/10(15:00)
2005,09,09,61737,56476,47653,8823,18.5,2005/09/09(20:00)
2005,09,08,61737,56012,48754,7258,14.9,2005/09/08(17:00)
2005,09,07,61737,56328,47953,8375,17.5,2005/09/07(15:00)
2005,09,06,61737,56091,45112,10979,24.3,2005/09/06(15:00)
2005,09,05,61737,56214,46476,9738,21,2005/09/05(17:00)
2005,09,04,61737,56961,39059,17902,45.8,2005/09/04(21:00)
2005,09,03,61737,56273,45178,11095,24.6,2005/09/03(12:00)
2005,09,02,61737,56612,52052,4560,8.8,2005/09/02(15:00)
2005,09,01,61737,57012,52752,4260,8.1,2005/09/01(15:00)
2005,08,31,61737,59268,49865,9403,18.9,2005/08/31(15:00)
2005,08,30,61737,59268,48676,10592,21.8,2005/08/30(15:00)
2005,08,29,61737,59268,48934,10334,21.1,2005/08/29(17:00)
2005,08,28,61737,59165,40011,19154,47.9,2005/08/28(21:00)
2005,08,27,61737,59165,43196,15969,37,2005/08/27(15:00)
2005,08,26,61737,59608,46025,13583,29.5,2005/08/26(15:00)
2005,08,25,61737,59608,45989,13619,29.6,2005/08/25(15:00)
2005,08,24,61737,60458,45508,14950,32.9,2005/08/24(15:00)
2005,08,23,61737,60848,47458,13390,28.2,2005/08/23(15:00)
2005,08,22,61737,60848,47123,13725,29.1,2005/08/22(15:00)
2005,08,21,61737,59906,39680,20226,51,2005/08/21(21:00)
2005,08,20,61737,60616,43183,17433,40.4,2005/08/20(12:00)
2005,08,19,61737,60848,49558,11290,22.8,2005/08/19(12:00)
2005,08,18,61737,60848,52747,8101,15.4,2005/08/18(12:00)
2005,08,17,61737,60818,54631,6187,11.3,2005/08/17(12:00)
2005,08,16,61737,60818,53601,7217,13.5,2005/08/16(17:00)
2005,08,15,61737,60334,45678,14656,32.1,2005/08/15(21:00)
2005,08,14,61737,60134,43033,17101,39.7,2005/08/14(21:00)
2005,08,13,61737,60576,47490,13086,27.6,2005/08/13(12:00)
2005,08,12,61737,60788,50419,10369,20.6,2005/08/12(12:00)
2005,08,11,61737,61061,49596,11465,23.1,2005/08/11(12:00)
2005,08,10,61737,61170,50228,10942,21.8,2005/08/10(12:00)
2005,08,09,61737,61170,50618,10552,20.8,2005/08/09(12:00)
2005,08,08,61737,59996,49468,10528,21.3,2005/08/08(12:00)
2005,08,07,61737,59903,43036,16867,39.2,2005/08/07(21:00)
2005,08,06,61737,60097,48041,12056,25.1,2005/08/06(12:00)
2005,08,05,61737,60859,51145,9714,19,2005/08/05(15:00)
2005,08,04,61737,60506,49045,11461,23.4,2005/08/04(15:00)
2005,08,03,61737,60506,44195,16311,36.9,2005/08/03(21:00)
2005,08,02,61737,59968,44052,15916,36.1,2005/08/02(15:00)
2005,08,01,61737,59905,43417,16488,38,2005/08/01(21:00)
2005,07,31,61737,58499,41304,17195,41.6,2005/07/31(21:00)
2005,07,30,61737,58699,44218,14481,32.7,2005/07/30(12:00)
2005,07,29,61737,60475,49939,10536,21.1,2005/07/29(15:00)
2005,07,28,61737,59937,49576,10361,20.9,2005/07/28(12:00)
2005,07,27,61737,59283,51903,7380,14.2,2005/07/27(12:00)
2005,07,26,61737,58202,52288,5914,11.3,2005/07/26(12:00)
2005,07,25,61737,58672,52230,6442,12.3,2005/07/25(12:00)
2005,07,24,61737,58041,44052,13989,31.8,2005/07/24(21:00)
2005,07,23,61737,58551,50239,8312,16.5,2005/07/23(15:00)
2005,07,22,61737,58985,53712,5273,9.8,2005/07/22(15:00)
2005,07,21,61737,58775,52725,6050,11.5,2005/07/21(15:00)
2005,07,20,61737,59214,52112,7102,13.6,2005/07/20(17:00)
2005,07,19,61737,58025,50965,7060,13.9,2005/07/19(12:00)
2005,07,18,61737,57980,51624,6356,12.3,2005/07/18(15:00)
2005,07,17,61737,57371,41595,15776,37.9,2005/07/17(21:00)
2005,07,16,61737,57099,46072,11027,23.9,2005/07/16(12:00)
2005,07,15,61737,57132,50200,6932,13.8,2005/07/15(15:00)
2005,07,14,61737,57464,49010,8454,17.2,2005/07/14(15:00)
2005,07,13,61737,57006,47016,9990,21.2,2005/07/13(17:00)
2005,07,12,61737,57006,46354,10652,23,2005/07/12(15:00)
2005,07,11,61737,57595,44711,12884,28.8,2005/07/11(15:00)
2005,07,10,61737,56394,39361,17033,43.3,2005/07/10(21:00)
2005,07,09,61737,56910,42719,14191,33.2,2005/07/09(12:00)
2005,07,08,61737,56826,48156,8670,18,2005/07/08(15:00)
2005,07,07,61737,57232,48010,9222,19.2,2005/07/07(15:00)
2005,07,06,61737,57018,48473,8545,17.6,2005/07/06(15:00)
2005,07,05,61737,55750,46511,9239,19.9,2005/07/05(15:00)
2005,07,04,61737,55416,47063,8353,17.7,2005/07/04(15:00)
2005,07,03,61737,55597,38646,16951,43.9,2005/07/03(21:00)
2005,07,02,61737,55060,43218,11842,27.4,2005/07/02(12:00)
2005,07,01,61737,55310,46720,8590,18.4,2005/07/01(15:00)
2005,06,30,61539,56330,50343,5987,11.9,2005/06/30(15:00)
2005,06,29,60994,57270,48559,8711,17.9,2005/06/29(15:00)
2005,06,28,60994,57112,48314,8798,18.2,2005/06/28(15:00)
2005,06,27,60994,55938,48664,7274,14.9,2005/06/27(15:00)
2005,06,26,60994,55006,40851,14155,34.7,2005/06/26(21:00)
2005,06,25,60994,54173,46104,8069,17.5,2005/06/25(12:00)
2005,06,24,60994,55209,50603,4606,9.1,2005/06/24(15:00)
2005,06,23,60994,55833,49956,5877,11.8,2005/06/23(15:00)
2005,06,22,60994,55833,48917,6916,14.1,2005/06/22(15:00)
2005,06,21,60994,55487,48473,7014,14.5,2005/06/21(15:00)
2005,06,19,60994,56578,38832,17746,45.7,2005/06/19(21:00)
2005,06,18,60994,57939,43198,14741,34.1,2005/06/18(12:00)
2005,06,17,60994,57389,46173,11216,24.3,2005/06/17(15:00)
2005,06,16,60994,57146,45891,11255,24.5,2005/06/16(15:00)
2005,06,15,60994,57266,45572,11694,25.7,2005/06/15(15:00)
2005,06,14,60994,56921,47528,9393,19.8,2005/06/14(15:00)
2005,06,13,60994,56172,46823,9349,20,2005/06/13(15:00)
2005,06,12,60994,56314,38490,17824,46.3,2005/06/12(21:00)
2005,06,11,60994,56235,41569,14666,35.3,2005/06/11(12:00)
2005,06,10,60994,57388,43949,13439,30.6,2005/06/10(12:00)
2005,06,09,60994,56094,46315,9779,21.1,2005/06/09(15:00)
2005,06,08,60994,55685,46046,9639,20.9,2005/06/08(15:00)
2005,06,07,60994,55404,44433,10971,24.7,2005/06/07(21:00)
2005,06,06,60994,56407,40088,16319,40.7,2005/06/06(21:00)
2005,06,05,60994,55580,36940,18640,50.5,2005/06/05(23:00)
2005,06,04,60994,56511,40480,16031,39.6,2005/06/04(12:00)
2005,06,03,60994,57578,43743,13835,31.6,2005/06/03(15:00)
2005,06,02,60994,57578,43468,14110,32.5,2005/06/02(21:00)
2005,06,01,60994,57041,43446,13595,31.3,2005/06/01(15:00)
2005,05,31,60994,57847,44049,13798,31.3,2005/05/31(15:00)
2005,05,30,60994,57604,44006,13598,30.9,2005/05/30(17:00)
2005,05,29,60994,57457,38225,19232,50.3,2005/05/29(21:00)
2005,05,28,60994,57567,40962,16605,40.5,2005/05/28(12:00)
2005,05,27,60994,56870,43871,12999,29.6,2005/05/27(15:00)
2005,05,26,60994,56683,44300,12383,28,2005/05/26(21:00)
2005,05,25,60994,55543,43624,11919,27.3,2005/05/25(21:00)
2005,05,24,60994,55746,43810,11936,27.2,2005/05/24(21:00)
2005,05,23,60994,55844,43763,12081,27.6,2005/05/23(23:00)
2005,05,22,60994,55742,38470,17272,44.9,2005/05/22(23:00)
2005,05,21,60994,56008,40514,15494,38.2,2005/05/21(23:00)
2005,05,20,60994,56066,43119,12947,30,2005/05/20(21:00)
2005,05,19,60994,56508,43532,12976,29.8,2005/05/19(21:00)
2005,05,18,60994,56613,43802,12811,29.2,2005/05/18(23:00)
2005,05,17,60994,56848,43981,12867,29.3,2005/05/17(21:00)
2005,05,16,60994,57180,43583,13597,31.2,2005/05/16(21:00)
2005,05,15,60994,56705,38025,18680,49.1,2005/05/15(23:00)
2005,05,14,60994,57281,40994,16287,39.7,2005/05/14(23:00)
2005,05,13,60994,56660,43561,13099,30.1,2005/05/13(23:00)
2005,05,12,60994,56460,44421,12039,27.1,2005/05/12(23:00)
2005,05,11,60994,56097,44392,11705,26.4,2005/05/11(23:00)
2005,05,10,60994,55790,44107,11683,26.5,2005/05/10(23:00)
2005,05,09,60994,56341,44072,12269,27.8,2005/05/09(23:00)
2005,05,08,60994,56714,38968,17746,45.5,2005/05/08(23:00)
2005,05,07,60994,56568,40987,15581,38,2005/05/07(23:00)
2005,05,06,60994,57597,43561,14036,32.2,2005/05/06(23:00)
2005,05,05,60994,58314,40743,17571,43.1,2005/05/05(23:00)
2005,05,04,60994,58314,43065,15249,35.4,2005/05/04(15:00)
2005,05,03,60994,57528,43554,13974,32.1,2005/05/03(21:00)
2005,05,02,60994,57207,42752,14455,33.8,2005/05/02(21:00)
2005,05,01,60994,57808,36678,21130,57.6,2005/05/01(23:00)
2005,04,30,60994,57969,40655,17314,42.6,2005/04/30(23:00)
2005,04,29,60994,58529,43318,15211,35.1,2005/04/29(21:00)
2005,04,28,60994,59305,43750,15555,35.6,2005/04/28(21:00)
2005,04,27,60994,59130,43615,15515,35.6,2005/04/27(23:00)
2005,04,26,60994,59137,44121,15016,34,2005/04/26(23:00)
2005,04,25,60994,58874,43672,15202,34.8,2005/04/25(23:00)
2005,04,24,60994,57613,39048,18565,47.5,2005/04/24(23:00)
2005,04,23,60994,57699,41787,15912,38.1,2005/04/23(23:00)
2005,04,22,60994,57896,44630,13266,29.7,2005/04/22(23:00)
2005,04,21,59993,57895,44922,12973,28.9,2005/04/21(23:00)
2005,04,20,59993,57355,44675,12680,28.4,2005/04/20(23:00)
2005,04,19,59993,57804,44446,13358,30.1,2005/04/19(23:00)
2005,04,18,59993,57804,44324,13480,30.4,2005/04/18(23:00)
2005,04,17,59993,56452,39316,17136,43.6,2005/04/17(23:00)
2005,04,16,59993,56652,42000,14652,34.9,2005/04/16(23:00)
2005,04,15,59993,57688,44758,12930,28.9,2005/04/15(23:00)
2005,04,14,59993,57395,44921,12474,27.8,2005/04/14(23:00)
2005,04,13,59993,57395,45044,12351,27.4,2005/04/13(23:00)
2005,04,12,59993,57240,45186,12054,26.7,2005/04/12(23:00)
2005,04,11,59993,57423,44792,12631,28.2,2005/04/11(23:00)
2005,04,10,59993,56865,39765,17100,43,2005/04/10(23:00)
2005,04,09,59993,56366,42386,13980,33,2005/04/09(23:00)
2005,04,08,59993,55884,44041,11843,26.9,2005/04/08(23:00)
2005,04,07,59993,56577,44676,11901,26.6,2005/04/07(23:00)
2005,04,06,59993,56579,45265,11314,25,2005/04/06(23:00)
2005,04,05,59993,56357,42685,13672,32,2005/04/05(23:00)
2005,04,04,59993,56130,44798,11332,25.3,2005/04/04(23:00)
2005,04,03,59993,55552,40539,15013,37,2005/04/03(23:00)
2005,04,02,59993,55482,41926,13556,32.3,2005/04/02(23:00)
2005,04,01,59993,56297,45123,11174,24.8,2005/04/01(23:00)
2005,03,31,59961,55478,45770,9708,21.2,2005/03/31(23:00)
2005,03,30,59961,55797,46029,9768,21.2,2005/03/30(23:00)
2005,03,29,59961,56592,46546,10046,21.6,2005/03/29(23:00)
2005,03,28,59961,56727,46478,10249,22.1,2005/03/28(23:00)
2005,03,27,59961,56034,41052,14982,36.5,2005/03/27(01:00)
2005,03,26,59961,56192,44215,11977,27.1,2005/03/26(01:00)
2005,03,25,59961,56715,46982,9733,20.7,2005/03/25(23:00)
2005,03,24,59961,56145,47815,8330,17.4,2005/03/24(23:00)
2005,03,23,59961,56708,46565,10143,21.8,2005/03/23(23:00)
2005,03,22,59961,56548,46539,10009,21.5,2005/03/22(23:00)
2005,03,21,59961,56410,46339,10071,21.7,2005/03/21(23:00)
2005,03,20,59961,56135,41783,14352,34.3,2005/03/20(23:00)
2005,03,19,59961,56291,44303,11988,27.1,2005/03/19(01:00)
2005,03,18,59961,56481,47386,9095,19.2,2005/03/18(23:00)
2005,03,17,59961,55813,47172,8641,18.3,2005/03/17(23:00)
2005,03,16,59961,55658,46814,8844,18.9,2005/03/16(23:00)
2005,03,15,59961,55753,47816,7937,16.6,2005/03/15(23:00)
2005,03,14,59961,56258,47709,8549,17.9,2005/03/14(23:00)
2005,03,13,59961,54348,44533,9815,22,2005/03/13(01:00)
2005,03,12,59961,54005,46440,7565,16.3,2005/03/12(23:00)
2005,03,11,59961,55886,48374,7512,15.5,2005/03/11(23:00)
2005,03,10,59961,55805,46742,9063,19.4,2005/03/10(23:00)
2005,03,09,59961,55796,46945,8851,18.9,2005/03/09(23:00)
2005,03,08,59961,55796,47363,8433,17.8,2005/03/08(23:00)
2005,03,07,59961,56665,47730,8935,18.7,2005/03/07(23:00)
2005,03,06,59961,56613,44565,12048,27,2005/03/06(01:00)
2005,03,05,59961,57332,46332,11000,23.7,2005/03/05(01:00)
2005,03,04,59961,57738,48698,9040,18.6,2005/03/04(23:00)
2005,03,03,59961,57047,49092,7955,16.2,2005/03/03(23:00)
2005,03,02,59961,57183,48722,8461,17.4,2005/03/02(23:00)
2005,03,01,59961,56739,46189,10550,22.8,2005/03/01(23:00)
2005,02,28,59961,57133,45646,11487,25.2,2005/02/28(05:00)
2005,02,26,59961,57305,47397,9908,20.9,2005/02/26(01:00)
2005,02,23,59961,57738,48821,8917,18.3,2005/02/23(23:00)
2005,02,21,59961,57366,49555,7811,15.8,2005/02/21(23:00)
2005,02,20,59961,55669,46950,8719,18.6,2005/02/20(23:00)
2005,02,18,59961,55697,48199,7498,15.6,2005/02/18(23:00)
2005,02,17,59961,56769,47802,8967,18.8,2005/02/17(23:00)
2005,02,15,59961,56858,47972,8886,18.5,2005/02/15(23:00)
2005,02,14,59961,56298,48186,8112,16.8,2005/02/14(23:00)
2005,02,13,59961,55879,43689,12190,27.9,2005/02/13(23:00)
2005,02,11,59961,57685,42630,15055,35.3,2005/02/11(23:00)
2005,02,10,59961,57685,38695,18990,49.1,2005/02/10(23:00)
2005,02,09,59961,57485,36073,21412,59.4,2005/02/09(23:00)
2005,02,07,59961,56980,42854,14126,33,2005/02/07(01:00)
2005,02,06,59961,56859,44788,12071,27,2005/02/06(01:00)
2005,02,04,59961,56987,49315,7672,15.6,2005/02/04(04:00)
2005,02,02,59961,56978,49820,7158,14.4,2005/02/02(23:00)
2005,02,01,59961,55978,49990,5988,12,2005/02/01(23:00)
2005,01,30,59961,55808,44556,11252,25.3,2005/01/30(01:00)
2005,01,29,59961,55808,46257,9551,20.6,2005/01/29(23:00)
2005,01,28,59961,55834,47775,8059,16.9,2005/01/28(23:00)
2005,01,26,59961,55137,48104,7033,14.6,2005/01/26(23:00)
2005,01,25,59961,54787,48099,6688,13.9,2005/01/25(23:00)
2005,01,24,59961,54787,48192,6595,13.7,2005/01/24(19:00)
2005,01,23,59961,54810,44446,10364,23.3,2005/01/23(01:00)
2005,01,21,59961,54876,49023,5853,11.9,2005/01/21(23:00)
2005,01,20,59961,55581,49201,6380,13,2005/01/20(19:00)
2005,01,19,59961,55326,48787,6539,13.4,2005/01/19(23:00)
2005,01,18,59961,55326,48280,7046,14.6,2005/01/18(23:00)
2005,01,17,59961,55938,48285,7653,15.8,2005/01/17(23:00)
2005,01,16,59961,55928,44757,11171,25,2005/01/16(01:00)
2005,01,15,59961,56338,46977,9361,19.9,2005/01/15(01:00)
2005,01,14,59961,57135,48843,8292,17,2005/01/14(23:00)
2005,01,13,59961,56527,49444,7083,14.3,2005/01/13(19:00)
2005,01,12,59961,56817,49337,7480,15.2,2005/01/12(23:00)
2005,01,11,59961,56124,49457,6667,13.5,2005/01/11(19:00)
2005,01,10,59961,54983,49683,5300,10.7,2005/01/10(19:00)
2005,01,09,59961,54344,45202,9142,20.2,2005/01/09(01:00)
2005,01,08,59961,54319,46689,7630,16.3,2005/01/08(23:00)
2005,01,07,59961,54818,48554,6264,12.9,2005/01/07(23:00)
2005,01,06,59961,56376,48187,8189,17,2005/01/06(19:00)
2005,01,05,59961,57429,48249,9180,19,2005/01/05(23:00)
2005,01,04,59961,57429,48671,8758,18,2005/01/04(19:00)
2005,01,03,59961,57331,47151,10180,21.6,2005/01/03(23:00)
2005,01,02,59961,57801,41507,16294,39.3,2005/01/02(23:00)
2005,01,01,59961,58011,42897,15114,35.2,2005/01/01(01:00)
2004,12,31,59961,58308,45574,12734,27.9,2004/12/31(01:00)
2004,12,30,59961,58258,47184,11074,23.5,2004/12/30(00:00)
2004,12,29,59943,58070,47965,10105,21.1,2004/12/29(23:00)
2004,12,28,59943,58532,48369,10163,21,2004/12/28(19:00)
2004,12,27,59943,58532,48087,10445,21.7,2004/12/27(23:00)
2004,12,26,59943,58532,42975,15557,36.2,2004/12/26(00:00)
2004,12,25,59943,58425,45457,12968,28.5,2004/12/25(01:00)
2004,12,24,59943,59225,47201,12024,25.5,2004/12/24(11:00)
2004,12,23,59943,59225,48549,10676,22,2004/12/23(23:00)
2004,12,22,59943,58953,48141,10812,22.5,2004/12/22(23:00)
2004,12,21,59943,58353,47834,10519,22,2004/12/21(19:00)
2004,12,20,59943,58531,47857,10674,22.3,2004/12/20(23:00)
2004,12,19,59943,58296,41839,16457,39.3,2004/12/19(01:00)
2004,12,18,59943,57499,43744,13755,31.4,2004/12/18(00:00)
2004,12,17,599430,58144,46315,11829,25.5,2004/12/17(23:00)
2004,12,16,59943,59016,46933,12083,25.7,2004/12/16(23:00)
2004,12,15,59943,59015,46284,12731,27.5,2004/12/15(23:00)
2004,12,14,59943,58319,46713,11606,24.8,2004/12/14(23:00)
2004,12,13,59943,58014,46884,11130,23.7,2004/12/13(23:00)
2004,12,12,59943,57934,41503,16431,39.6,2004/12/12(01:00)
2004,12,11,59943,57934,43551,14383,33,2004/12/11(23:00)
2004,12,10,59943,57704,46369,11335,24.4,2004/12/10(23:00)
2004,12,09,59943,58058,46387,11671,25.2,2004/12/09(23:00)
2004,12,08,59943,58058,46265,11793,25.5,2004/12/08(23:00)
2004,12,07,59943,57948,46401,11547,24.9,2004/12/07(19:00)
2004,12,06,59943,58080,46307,11773,25.4,2004/12/06(19:00)
2004,12,05,59943,57368,41223,16145,39.2,2004/12/05(23:00)
2004,12,04,59943,57370,42651,14719,34.5,2004/12/04(23:00)
2004,12,03,59943,57472,45178,12294,27.2,2004/12/03(23:00)
2004,12,02,59943,57730,45878,11852,25.8,2004/12/02(23:00)
2004,12,01,59943,57730,46150,11580,25.1,2004/12/01(23:00)
2004,11,30,59943,57780,46241,11539,25,2004/11/30(23:00)
2004,11,29,59129,58849,45910,12939,28.2,2004/11/29(23:00)
2004,11,28,59129,57741,40717,17024,41.8,2004/11/28(23:00)
2004,11,27,59129,57703,42870,14833,34.6,2004/11/27(01:00)
2004,11,26,59129,58063,45776,12287,26.8,2004/11/26(23:00)
2004,11,25,59129,57792,45420,12372,27.2,2004/11/25(23:00)
2004,11,24,59129,56984,45550,11434,25.1,2004/11/24(23:00)
2004,11,23,59129,56784,45794,10990,24,2004/11/23(23:00)
2004,11,22,59129,56784,45445,11339,25,2004/11/22(23:00)
2004,11,21,59129,55934,40224,15710,39.1,2004/11/21(23:00)
2004,11,20,59129,55848,42809,13039,30.5,2004/11/20(23:00)
2004,11,19,59129,54789,45062,9727,21.6,2004/11/19(23:00)
2004,11,18,59129,54789,45183,9606,21.3,2004/11/18(23:00)
2004,11,17,59129,53865,45340,8525,18.8,2004/11/17(23:00)
2004,11,16,59129,53865,45322,8543,18.8,2004/11/16(19:00)
2004,11,15,59129,53817,45572,8245,18.1,2004/11/15(19:00)
2004,11,14,59129,53456,39781,13675,34.4,2004/11/14(01:00)
2004,11,13,59129,53717,42256,11461,27.1,2004/11/13(23:00)
2004,11,12,59129,53097,44745,8352,18.7,2004/11/12(23:00)
2004,11,11,59129,53114,44330,8784,19.8,2004/11/11(23:00)
2004,11,10,59129,52840,44065,8775,19.9,2004/11/10(23:00)
2004,11,09,59129,53021,44231,8790,19.9,2004/11/09(17:00)
2004,11,08,59129,53663,44661,9002,20.2,2004/11/08(19:00)
2004,11,07,59129,53326,38822,14504,37.4,2004/11/07(23:00)
2004,11,06,59129,53444,41418,12026,29,2004/11/06(23:00)
2004,11,05,59129,52913,44047,8866,20.1,2004/11/05(19:00)
2004,11,04,59129,53313,44401,8912,20.1,2004/11/04(19:00)
2004,11,03,59129,53290,44226,9064,20.5,2004/11/03(23:00)
2004,11,02,59129,52432,44409,8023,18.1,2004/11/02(19:00)
2004,11,01,59129,52432,43655,8777,20.1,2004/11/01(19:00)
2004,10,31,59129,51698,38285,13413,35,2004/10/31(23:00)
2004,10,30,59129,51647,40659,10988,27,2004/10/30(23:00)
2004,10,29,59129,51913,43129,8784,20.4,2004/10/29(19:00)
2004,10,28,59129,51858,43869,7989,18.2,2004/10/28(19:00)
2004,10,27,59129,51534,43601,7933,18.2,2004/10/27(23:00)
2004,10,26,59129,51556,44272,7284,16.5,2004/10/26(19:00)
2004,10,25,59129,51987,43891,8096,18.4,2004/10/25(19:00)
2004,10,24,59129,51834,38251,13583,35.5,2004/10/24(23:00)
2004,10,23,59129,51834,40868,10966,26.8,2004/10/23(23:00)
2004,10,22,59129,52077,43106,8971,20.8,2004/10/22(23:00)
2004,10,21,59129,51919,43757,8162,18.7,2004/10/21(19:00)
2004,10,20,59129,51799,43037,8762,20.4,2004/10/20(23:00)
2004,10,19,59129,50815,43532,7283,16.7,2004/10/19(19:00)
2004,10,18,59129,51269,43027,8242,19.2,2004/10/18(19:00)
2004,10,17,59129,51269,37717,13552,35.9,2004/10/17(23:00)
2004,10,16,59129,51225,40224,11001,27.3,2004/10/16(23:00)
2004,10,15,59129,51869,42771,9098,21.3,2004/10/15(23:00)
2004,10,14,59129,50758,43089,7669,17.8,2004/10/14(23:00)
2004,10,13,59129,50837,42573,8264,19.4,2004/10/13(23:00)
2004,10,12,59129,50815,42769,8046,18.8,2004/10/12(19:00)
2004,10,11,59129,50862,43191,7671,17.8,2004/10/11(20:00)
2004,10,10,59129,50444,36952,13492,36.5,2004/10/10(23:00)
2004,10,09,59129,50319,39498,10821,27.4,2004/10/09(23:00)
2004,10,08,59129,50617,43098,7519,17.4,2004/10/08(20:00)
2004,10,07,59129,49988,43244,6744,15.6,2004/10/07(19:00)
2004,10,06,59129,49988,42689,7299,17.1,2004/10/06(20:00)
2004,10,05,59129,50566,43035,7531,17.5,2004/10/05(20:00)
2004,10,04,59129,50182,42683,7499,17.6,2004/10/04(20:00)
2004,10,03,59129,50687,37159,13528,36.4,2004/10/03(23:00)
2004,10,02,59129,50744,39098,11646,29.8,2004/10/02(23:00)
2004,10,01,59129,51843,41007,10836,26.4,2004/10/01(20:00)
2004,09,30,59129,53953,37811,16142,42.7,2004/09/30(20:00)
2004,09,29,59129,54418,31357,23061,73.5,2004/09/29(23:00)
2004,09,28,59129,52870,28783,24087,83.7,2004/09/28(23:00)
2004,09,27,59129,52870,30354,22516,74.2,2004/09/27(01:00)
2004,09,26,59129,52870,34265,18605,54.3,2004/09/26(23:00)
2004,09,25,59129,52915,37974,14941,39.3,2004/09/25(12:00)
2004,09,24,59129,53688,42841,10847,25.3,2004/09/24(20:00)
2004,09,23,59129,53437,43671,9766,22.4,2004/09/23(20:00)
2004,09,22,59129,53605,43231,10374,24,2004/09/22(20:00)
2004,09,21,59129,53852,43588,10264,23.5,2004/09/21(20:00)
2004,09,20,59129,53041,43493,9548,22,2004/09/20(20:00)
2004,09,19,59129,52839,37165,15674,42.2,2004/09/19(20:00)
2004,09,18,59129,52943,42709,10234,24,2004/09/18(12:00)
2004,09,17,59129,53257,46566,6691,14.4,2004/09/17(15:00)
2004,09,16,59129,53597,46177,7420,16.1,2004/09/16(20:00)
2004,09,15,59129,53107,45571,7536,16.5,2004/09/15(20:00)
2004,09,14,59129,52686,45342,7344,16.2,2004/09/14(20:00)
2004,09,13,59129,52297,44751,7546,16.9,2004/09/13(20:00)
2004,09,12,59129,52080,37337,14743,39.5,2004/09/12(21:00)
2004,09,11,59129,51126,39784,11342,28.5,2004/09/11(12:00)
2004,09,10,59129,53313,43683,9630,22,2004/09/10(15:00)
2004,09,09,59129,53571,44583,8988,20.2,2004/09/09(20:00)
2004,09,08,59129,53691,44370,9321,21,2004/09/08(17:00)
2004,09,07,59129,53691,43830,9861,22.5,2004/09/07(20:00)
2004,09,06,59129,53682,45493,8189,18,2004/09/06(20:00)
2004,09,05,59129,53782,38145,15637,41,2004/09/05(20:00)
2004,09,04,59129,53939,42686,11253,26.4,2004/09/04(15:00)
2004,09,03,59129,54110,45438,8672,19.1,2004/09/03(15:00)
2004,09,02,59129,54553,46060,8493,18.4,2004/09/02(15:00)
2004,09,01,59129,55249,46594,8655,18.6,2004/09/01(15:00)
2004,08,31,59129,58260,47045,11215,23.8,2004/08/31(15:00)
2004,08,30,59129,57664,46686,10978,23.5,2004/08/30(17:00)
2004,08,29,59129,57921,38850,19071,49.1,2004/08/29(21:00)
2004,08,27,59129,58271,45653,12618,27.6,2004/08/27(15:00)
2004,08,26,59129,58380,45207,13173,29.1,2004/08/26(15:00)
2004,08,25,59129,58399,45348,13051,28.8,2004/08/25(15:00)
2004,08,24,59129,58469,44796,13673,30.5,2004/08/24(16:00)
2004,08,23,59129,58240,43413,14827,34.2,2004/08/23(15:00)
2004,08,22,59129,58318,36519,21799,59.7,2004/08/22(21:00)
2004,08,21,59129,58089,41450,16639,40.1,2004/08/21(12:00)
2004,08,20,59129,58089,44228,13861,31.3,2004/08/20(12:00)
2004,08,19,59129,58318,43971,14347,32.6,2004/08/19(12:00)
2004,08,18,59129,58318,47295,11023,23.3,2004/08/18(12:00)
2004,08,17,59129,58307,48673,9634,19.8,2004/08/17(12:00)
2004,08,16,59129,58677,48001,10676,22.2,2004/08/16(12:00)
2004,08,15,59129,57835,39399,18436,46.8,2004/08/15(21:00)
2004,08,14,59129,57965,46073,11892,25.8,2004/08/14(12:00)
2004,08,13,59129,58392,51184,7208,14.1,2004/08/13(12:00)
2004,08,12,59129,58541,50487,8054,16,2004/08/12(12:00)
2004,08,11,59129,58357,50100,8257,16.5,2004/08/11(12:00)
2004,08,10,59129,58029,50795,7234,14.2,2004/08/10(12:00)
2004,08,09,59129,58021,49819,8202,16.5,2004/08/09(17:00)
2004,08,08,59129,57132,41690,15442,37,2004/08/08(21:00)
2004,08,07,59129,57132,46279,10853,23.5,2004/08/07(12:00)
2004,08,06,59129,58077,48856,9221,18.9,2004/08/06(15:00)
2004,08,05,59129,57087,47392,9695,20.5,2004/08/05(15:00)
2004,08,04,59129,58077,45731,12346,27,2004/08/04(15:00)
2004,08,03,59129,58077,43888,14189,32.3,2004/08/03(15:00)
2004,08,02,59129,58135,43118,15017,34.8,2004/08/02(15:00)
2004,08,01,59129,56561,39349,17212,43.7,2004/08/01(21:00)
2004,07,31,59129,56451,44749,11702,26.2,2004/07/31(12:00)
2004,07,30,59129,57178,50759,6419,12.6,2004/07/30(15:00)
2004,07,29,59129,57528,51264,6264,12.2,2004/07/29(15:00)
2004,07,28,58129,57052,51227,5825,11.4,2004/07/28(15:00)
2004,07,27,58129,55960,49736,6224,12.5,2004/07/27(12:00)
2004,07,26,58129,55869,48756,7113,14.6,2004/07/26(12:00)
2004,07,25,58129,56294,39760,16534,41.6,2004/07/25(21:00)
2004,07,24,58129,56728,46076,10652,23.1,2004/07/24(12:00)
2004,07,23,58129,57254,50167,7087,14.1,2004/07/23(15:00)
2004,07,22,58129,57487,49704,7783,15.7,2004/07/22(15:00)
2004,07,21,58129,56822,48880,7942,16.2,2004/07/21(17:00)
2004,07,20,58129,56442,47511,8931,18.8,2004/07/20(12:00)
2004,07,19,58129,56442,46608,9834,21.1,2004/07/19(15:00)
2004,07,18,58129,54132,38551,15581,40.4,2004/07/18(21:00)
2004,07,17,58129,53912,39544,14368,36.3,2004/07/17(21:00)
2004,07,16,58129,53774,46023,7751,16.8,2004/07/16(15:00)
2004,07,15,58129,54458,45245,9213,20.4,2004/07/15(17:00)
2004,07,14,58129,54488,45286,9202,20.3,2004/07/14(17:00)
2004,07,13,58129,53963,44875,9088,20.3,2004/07/13(15:00)
2004,07,12,58129,54225,45145,9080,20.1,2004/07/12(15:00)
2004,07,11,57328,53203,37054,16149,43.6,2004/07/11(21:00)
2004,07,10,57328,53836,41626,12210,29.3,2004/07/10(12:00)
2004,07,09,57328,54225,44954,9271,20.6,2004/07/09(15:00)
2004,07,08,57328,54089,43850,10239,23.4,2004/07/08(15:00)
2004,07,07,57328,54265,43965,10300,23.4,2004/07/07(15:00)
2004,07,06,57328,53881,45705,8176,17.9,2004/07/06(17:00)
2004,07,05,57328,53796,43834,9962,22.7,2004/07/05(17:00)
2004,07,04,57328,52470,36176,16294,45,2004/07/04(21:00)
2004,07,03,57328,51163,42381,8782,20.7,2004/07/03(15:00)
2004,07,02,57328,52412,44135,8277,18.8,2004/07/02(15:00)
2004,07,01,57328,52398,44998,7400,16.4,2004/07/01(15:00)
2004,06,30,56980,52863,45538,7325,16.1,2004/06/30(15:00)
2004,06,29,56980,53044,44489,8555,19.2,2004/06/29(15:00)
2004,06,28,56980,52779,45087,7692,17.1,2004/06/28(15:00)
2003,09,10,56081,52471,31712,20759,65.5,2003/09/10(01:00)
2003,09,09,56081,52692,40705,11987,29.4,2003/09/09(12:00)
2003,09,08,56081,52582,44412,8170,18.4,2003/09/08(15:00)
2003,09,06,56081,52308,41910,10398,24.8,2003/09/06(12:00)
2003,09,05,56081,52635,44880,7755,17.3,2003/09/05(15:00)
2003,09,04,56081,52592,44191,8401,19,2003/09/04(20:00)
2003,09,03,56081,52450,42872,9578,22.3,2003/09/03(15:00)
2003,09,02,56081,52019,42057,9962,23.7,2003/09/02(20:00)
2003,09,01,56081,52775,41898,10877,26,2003/09/01(16:00)
2003,08,31,56081,52541,34564,17977,52,2003/08/31(21:00)
2003,08,30,56081,52986,39933,13053,32.7,2003/08/30(12:00)
2003,08,29,56081,54176,42649,11527,27,2003/08/29(15:00)
2003,08,28,56081,54166,43993,10173,23.1,2003/08/28(15:00)
2003,08,27,56081,54176,42201,11975,28.4,2003/08/27(12:00)
2003,08,26,56081,54877,44314,10563,23.8,2003/08/26(15:00)
2003,08,25,56081,54887,44718,10169,22.7,2003/08/25(15:00)
2003,08,24,56081,54050,37125,16925,45.6,2003/08/24(21:00)
2003,08,23,56081,54653,43491,11162,25.7,2003/08/23(12:00)
2003,08,22,56081,55488,47385,8103,17.1,2003/08/22(12:00)
2003,08,21,56081,55488,45982,9506,20.7,2003/08/21(12:00)
2003,08,20,56081,55488,44283,11205,25.3,2003/08/20(12:00)
2003,08,19,56081,55488,41858,13630,32.6,2003/08/19(20:00)
2003,08,18,56081,55488,40681,14807,36.4,2003/08/18(12:00)
2003,08,17,56081,55254,34121,21133,61.9,2003/08/17(21:00)
2003,08,16,56081,55254,36855,18399,49.9,2003/08/16(12:00)
2003,08,15,56081,55488,37476,18012,48.1,2003/08/15(21:00)
2003,08,14,56081,55448,42440,13008,30.7,2003/08/14(12:00)
2003,08,13,56081,55448,41942,13506,32.2,2003/08/13(12:00)
2003,08,12,56081,55438,42839,12599,29.4,2003/08/12(12:00)
2003,08,11,56081,55488,41755,13733,32.9,2003/08/11(12:00)
2003,08,10,56081,54681,40316,14365,35.6,2003/08/10(21:00)
2003,08,09,56081,55054,40316,14738,36.6,2003/08/09(12:00)
2003,08,08,56081,55288,41628,13660,32.8,2003/08/08(12:00)
2003,08,07,56081,55288,40365,14923,37,2003/08/07(12:00)
2003,08,06,56081,54521,42811,11710,27.4,2003/08/06(12:00)
2003,08,05,56081,53851,43728,10123,23.1,2003/08/05(15:00)
2003,08,02,56081,55235,36038,19197,53.3,2003/08/02(21:00)
2003,08,01,56081,55724,37626,18098,48.1,2003/08/01(15:00)
2003,07,31,56081,55468,39668,15800,39.8,2003/07/31(15:00)
2003,07,30,56071,55714,41298,14416,34.9,2003/07/30(15:00)
2003,07,29,56071,55448,41145,14303,34.8,2003/07/29(15:00)
2003,07,28,56071,55818,39655,16163,40.8,2003/07/28(15:00)
2003,07,27,56071,55323,34119,21204,62.1,2003/07/27(21:00)
2003,07,26,56071,55023,40087,14936,37.3,2003/07/26(12:00)
2003,07,25,56071,55818,42485,13333,31.4,2003/07/25(12:00)
2003,07,24,56071,55743,42301,13442,31.8,2003/07/24(12:00)
2003,07,23,56071,55818,42420,13398,31.6,2003/07/23(12:00)
2003,07,22,56071,55818,42199,13619,32.3,2003/07/22(12:00)
2003,07,21,56071,55818,42160,13658,32.4,2003/07/21(12:00)
2003,07,20,56071,55833,34878,20955,60.1,2003/07/20(21:00)
2003,07,19,56071,55421,37289,18132,48.6,2003/07/19(12:00)
2003,07,18,56071,55808,39704,16104,40.6,2003/07/18(15:00)
2003,07,17,56071,55298,37364,17934,48,2003/07/17(21:00)
2003,07,16,56071,55808,43027,12781,29.7,2003/07/16(15:00)
2003,07,15,56071,55723,42510,13213,31.1,2003/07/15(15:00)
2003,07,14,56071,55598,40852,14746,36.1,2003/07/14(15:00)
2003,07,13,56071,55608,34307,21301,62.1,2003/07/13(21:00)
2003,07,12,56071,55292,39070,16222,41.5,2003/07/12(12:00)
2003,07,11,56071,55548,42078,13470,32,2003/07/11(15:00)
2003,07,10,56071,55463,42169,13294,31.5,2003/07/10(15:00)
2003,07,09,56071,55463,42071,13392,31.8,2003/07/09(15:00)
2003,07,08,56071,55508,42156,13352,31.7,2003/07/08(15:00)
2003,07,07,56071,55082,41566,13516,32.5,2003/07/07(15:00)
2003,07,06,56071,55294,34736,20558,59.2,2003/07/06(21:00)
2003,07,05,56071,54919,38712,16207,41.9,2003/07/05(12:00)
2003,07,04,56071,54836,40197,14639,36.4,2003/07/04(15:00)
2003,07,03,56071,54412,39778,14634,36.8,2003/07/03(21:00)
2003,07,02,56071,54708,41999,12709,30.3,2003/07/02(15:00)
2003,07,01,56071,53908,40844,13064,32,2003/07/01(15:00)
2003,06,30,56071,52810,40949,11861,29,2003/06/30(15:00)
2002,09,13,52799,48930,39394,9536,24.2,2002/09/13(15:00)
2002,09,11,52799,48263,42895,5368,12.5,2002/09/11(15:00)
2002,09,10,52799,48977,42055,6922,16.5,2002/09/10(15:00)
2002,09,09,52799,49307,41524,7783,18.7,2002/09/09(15:00)
2002,09,08,52799,49285,33660,15625,46.4,2002/09/08(21:00)
2002,09,07,52799,49725,38087,11638,30.6,2002/09/07(12:00)
2002,09,06,52799,50051,40801,9250,22.7,2002/09/06(15:00)
2002,09,05,52799,50287,42685,7602,17.8,2002/09/05(15:00)
2002,09,04,52799,50426,44068,6358,14.4,2002/09/04(15:00)
2002,09,03,52799,50628,44524,6104,13.7,2002/09/03(15:00)
2002,09,02,52799,50438,42656,7782,18.2,2002/09/02(17:00)
2002,09,01,52799,50438,32690,17748,54.3,2002/09/01(21:00)
2002,08,31,52799,52068,38975,13093,33.6,2002/08/31(12:00)
2002,08,30,52799,52113,43222,8891,20.6,2002/08/30(15:00)
2002,08,29,52799,52113,45773,6340,13.9,2002/08/29(15:00)
2002,08,28,52799,52113,44236,7877,17.8,2002/08/28(15:00)
2002,08,27,52799,52013,43246,8767,20.3,2002/08/27(15:00)
2002,08,26,52799,52013,43700,8313,19,2002/08/26(15:00)
2002,08,25,52799,51651,35167,16484,46.9,2002/08/25(21:00)
2002,08,24,52799,51955,40845,11110,27.2,2002/08/24(12:00)
2002,08,23,52799,52391,41864,10527,25.1,2002/08/23(15:00)
2002,08,22,52799,52391,40605,11786,29,2002/08/22(12:00)
2002,08,21,52799,52290,40722,11568,28.4,2002/08/21(12:00)
2002,08,20,52799,52131,40175,11956,29.8,2002/08/20(12:00)
2002,08,19,52799,52509,39742,12767,32.1,2002/08/19(12:00)
2002,08,18,52649,52268,33762,18506,54.8,2002/08/18(21:00)
2002,08,17,52649,52058,37285,14773,39.6,2002/08/17(12:00)
2002,08,16,52649,52583,39134,13449,34.4,2002/08/16(12:00)
2002,08,15,52649,52633,39134,13499,34.5,2002/08/15(12:00)
2002,08,14,52649,52259,38553,13706,35.6,2002/08/14(12:00)
2002,08,13,52649,52609,38319,14290,37.3,2002/08/13(12:00)
2002,08,12,52649,52609,37157,15452,41.6,2002/08/12(12:00)
2002,08,11,52649,51866,31037,20829,67.1,2002/08/11(23:00)
2002,08,10,52649,52318,36618,15700,42.9,2002/08/10(12:00)
2002,08,09,52649,52527,39929,12598,31.6,2002/08/09(12:00)
2002,08,08,52649,52373,39419,12954,32.9,2002/08/08(17:00)
2002,08,07,52649,52373,39290,13083,33.3,2002/08/07(12:00)
2002,08,06,52649,52533,40494,12039,29.7,2002/08/06(12:00)
2002,08,05,52649,52533,42346,10187,24.1,2002/08/05(15:00)
2002,08,04,52649,52019,35175,16844,47.9,2002/08/04(21:00)
2002,08,03,52649,52019,36076,15943,44.2,2002/08/03(21:00)
2002,08,02,52649,52493,37528,14965,39.9,2002/08/02(15:00)
2002,08,01,52649,52493,38821,13672,35.2,2002/08/01(15:00)
2002,07,31,52649,52132,41730,10402,24.9,2002/07/31(15:00)
2002,07,30,52649,52132,42946,9186,21.4,2002/07/30(15:00)
2002,07,29,52649,52132,43437,8695,20,2002/07/29(15:00)
2002,07,28,52649,51666,37317,14349,38.5,2002/07/28(21:00)
2002,07,27,52649,51357,42322,9035,21.3,2002/07/27(12:00)
2002,07,26,52649,51254,43027,8227,19.1,2002/07/26(12:00)
2002,07,25,52649,51354,44306,7048,15.9,2002/07/25(15:00)
2002,07,24,52649,51199,42734,8465,19.8,2002/07/24(12:00)
2002,07,23,52649,51180,41497,9683,23.3,2002/07/23(12:00)
2002,07,22,52649,51239,41914,9325,22.2,2002/07/22(12:00)
2002,07,21,52649,50563,34318,16245,47.3,2002/07/21(21:00)
2002,07,20,52649,50376,38543,11833,30.7,2002/07/20(12:00)
2002,07,19,52649,51144,39903,11241,28.2,2002/07/19(12:00)
2002,07,18,52649,51027,41518,9509,22.9,2002/07/18(17:00)
2002,07,17,52649,51880,37854,14026,37.1,2002/07/17(21:00)
2002,07,16,52649,51880,43612,8268,19,2002/07/16(15:00)
2002,07,15,52649,51870,43772,8098,18.5,2002/07/15(17:00)
2002,07,14,52649,49805,34557,15248,44.1,2002/07/14(21:00)
2002,07,13,52649,50624,39749,10875,27.4,2002/07/13(12:00)
2002,07,12,52649,52195,42508,9687,22.8,2002/07/12(15:00)
2002,07,11,52649,51995,42190,9805,23.2,2002/07/11(15:00)
2002,07,10,52649,52167,42044,10123,24.1,2002/07/10(15:00)
2001,07,26,49632,48699,43125,5574,12.9,2001/07/26(15:00)
2000,08,18,47876,46078,41007,5071,12.4,2000/08/18(12:00)
1999,08,17,44427,43418,37293,6125,16.4,1999/08/17(17:00)
1998,09,10,43261,37928,32996,4932,14.9,1998/09/10(15:00)
1997,08,20,40534,38452,35851,2601,7.3,1997/08/20(12:00)
1996,08,13,35722,34295,32282,2013,6.2,1996/08/13(15:00)
1995,08,18,31793,31968,29878,2090,7,1995/08/18(15:00)
1994,07,22,28772,27431,26696,735,2.8,1994/07/22(15:00)
1993,12,16,27154,24405,22112,2293,10.4,1993/12/16(19:00)
